id,bank_account_id,transaction_date,description,amount,type,balance_after,matched_gltran_id,created_by,created_at,modified_by,modified_at
af267ea1d9c049c091949d611b318d0c,34d4c182e9a24b2ba115f8813d25c570,2025-03-13,Technology keep political cultural chance condition.,2201.46,Credit,52201.46,,system,2025-06-08 17:17:13.561036,system,2025-06-08 17:17:13.561036
4fa7e7adf14843c49f0758cbc02f464f,34d4c182e9a24b2ba115f8813d25c570,2025-02-27,Buy them not try.,-2533.99,Debit,49667.47,,system,2025-06-08 17:17:13.561036,system,2025-06-08 17:17:13.561036
0a6ffc8f629949fa9e10fe3150b27f6f,34d4c182e9a24b2ba115f8813d25c570,2025-03-17,Commercial speech finish big structure war these.,1003.53,Credit,50671.0,,system,2025-06-08 17:17:13.561036,system,2025-06-08 17:17:13.561036
049dcc9001b249b5b37228258fb3c6f4,34d4c182e9a24b2ba115f8813d25c570,2025-03-20,Science compare need who car carry him under.,345.77,Credit,51016.77,,system,2025-06-08 17:17:13.561036,system,2025-06-08 17:17:13.561036
a3c330029a9547a1a864c26f099992f5,34d4c182e9a24b2ba115f8813d25c570,2025-01-10,Important career paper identify behind product.,-414.64,Debit,50602.13,,system,2025-06-08 17:17:13.561036,system,2025-06-08 17:17:13.561036
c2db633841e244ba9e71a0bae25eca8c,34d4c182e9a24b2ba115f8813d25c570,2025-03-02,Free may job then what.,4281.67,Credit,54883.8,,system,2025-06-08 17:17:13.561036,system,2025-06-08 17:17:13.561036
bbe5fd8b4c9b4b9eb647dea14236c03e,34d4c182e9a24b2ba115f8813d25c570,2025-02-01,Whether already professor least personal.,-3258.83,Debit,51624.97,,system,2025-06-08 17:17:13.561036,system,2025-06-08 17:17:13.561036
dff267a7f1354230bc65abe60b8b5945,34d4c182e9a24b2ba115f8813d25c570,2025-03-04,Different about member he strategy.,631.0,Credit,52255.97,,system,2025-06-08 17:17:13.561036,system,2025-06-08 17:17:13.561036
9b88c65e636e4701b85294cbe52f78a7,34d4c182e9a24b2ba115f8813d25c570,2025-03-29,Wall care best trade force large.,-4850.54,Debit,47405.43,,system,2025-06-08 17:17:13.561036,system,2025-06-08 17:17:13.561036
ed9ed895299b47bd86837f88f52557e6,34d4c182e9a24b2ba115f8813d25c570,2025-02-13,Official country cold east.,-3354.58,Debit,44050.85,,system,2025-06-08 17:17:13.561036,system,2025-06-08 17:17:13.561036
dbc89aa823ac4e3e85b279349e5dc7a9,9a6a2559cb894a14a7beaefb3d27d713,2025-04-15,Make base book require cost economic why whose.,-4385.66,Debit,45614.34,,system,2025-06-08 17:17:13.561036,system,2025-06-08 17:17:13.561036
63814a5b68b74fd99b6c6da01b42fa76,9a6a2559cb894a14a7beaefb3d27d713,2025-05-03,Than rest house suddenly site still.,-2783.77,Debit,42830.57,,system,2025-06-08 17:17:13.561036,system,2025-06-08 17:17:13.561036
cb5206fbd8a34137929ea751c059f1a1,9a6a2559cb894a14a7beaefb3d27d713,2025-03-14,Sign work run notice development.,1205.83,Credit,44036.4,,system,2025-06-08 17:17:13.561036,system,2025-06-08 17:17:13.561036
f9f73a9721fa418d8a9222280de6e87d,9a6a2559cb894a14a7beaefb3d27d713,2025-03-26,Drug mind condition local necessary.,1756.57,Credit,45792.97,,system,2025-06-08 17:17:13.561036,system,2025-06-08 17:17:13.561036
eb1c5cd24d774295bab94e0bcb3a8a53,9a6a2559cb894a14a7beaefb3d27d713,2025-04-13,Campaign though mind ago likely report.,-1411.64,Debit,44381.33,,system,2025-06-08 17:17:13.561036,system,2025-06-08 17:17:13.561036
78effb391e5744ee8fb784ff9d066afd,9a6a2559cb894a14a7beaefb3d27d713,2025-03-18,Walk lay institution section foot these.,3483.23,Credit,47864.56,,system,2025-06-08 17:17:13.561036,system,2025-06-08 17:17:13.561036
d95da4a7ee0a45248d9445f02e42b636,9a6a2559cb894a14a7beaefb3d27d713,2025-05-04,Her commercial bit box drop hotel human.,1400.36,Credit,49264.92,,system,2025-06-08 17:17:13.561036,system,2025-06-08 17:17:13.561036
cce72d4bc09943bfa2ace4794b1ee66b,9a6a2559cb894a14a7beaefb3d27d713,2025-04-12,Happen later computer care network.,253.61,Credit,49518.53,,system,2025-06-08 17:17:13.561036,system,2025-06-08 17:17:13.561036
4942b3f5f43f4f789c928711c07e2a54,9a6a2559cb894a14a7beaefb3d27d713,2025-06-03,Scientist star return can it risk everybody.,-4539.1,Debit,44979.43,,system,2025-06-08 17:17:13.561036,system,2025-06-08 17:17:13.561036
1e342893067b4a32a0072bd3a695a540,9a6a2559cb894a14a7beaefb3d27d713,2025-05-04,Then issue example tax tree ball only.,4116.48,Credit,49095.91,,system,2025-06-08 17:17:13.561036,system,2025-06-08 17:17:13.561036
0a439bfe839b4c25a0ecb3b4b229c40b,c27368dad75943f0b77e5db348d969d6,2025-02-28,Matter back pretty society.,1051.01,Credit,51051.01,,system,2025-06-08 17:17:13.561036,system,2025-06-08 17:17:13.561036
df93129e670e44968c8969e68012c9ea,c27368dad75943f0b77e5db348d969d6,2024-12-14,Energy table we follow.,-3161.79,Debit,47889.22,,system,2025-06-08 17:17:13.561036,system,2025-06-08 17:17:13.561036
51e2fba10ce34af481c30036f0ea25d2,c27368dad75943f0b77e5db348d969d6,2025-05-16,West tough lawyer above state.,1172.37,Credit,49061.59,,system,2025-06-08 17:17:13.561036,system,2025-06-08 17:17:13.561036
b944825318384b168dd809e98178d378,c27368dad75943f0b77e5db348d969d6,2025-05-14,Order generation side theory require.,-573.78,Debit,48487.81,,system,2025-06-08 17:17:13.561036,system,2025-06-08 17:17:13.561036
430c2f34b6044f17854c0a8d40b8210a,c27368dad75943f0b77e5db348d969d6,2025-04-29,Whose including election nice before miss.,-146.27,Debit,48341.54,,system,2025-06-08 17:17:13.561036,system,2025-06-08 17:17:13.561036
d82ebff88c134461864dfa5e91b7a431,c27368dad75943f0b77e5db348d969d6,2025-05-06,City task strategy sound hot fund.,1002.39,Credit,49343.93,,system,2025-06-08 17:17:13.561036,system,2025-06-08 17:17:13.561036
88c77df9fa77496db8a3b80afb2302a1,c27368dad75943f0b77e5db348d969d6,2025-05-17,Financial bank add drive our enough.,-4735.57,Debit,44608.36,,system,2025-06-08 17:17:13.561036,system,2025-06-08 17:17:13.561036
0025474e76ca4486b2211d6952a147f3,c27368dad75943f0b77e5db348d969d6,2025-01-21,With rock eye modern.,-927.29,Debit,43681.07,,system,2025-06-08 17:17:13.561036,system,2025-06-08 17:17:13.561036
cad6b667de694777ba89f1f3f86e4b51,c27368dad75943f0b77e5db348d969d6,2025-04-24,Bill near huge language development decision myself.,4276.11,Credit,47957.18,,system,2025-06-08 17:17:13.561036,system,2025-06-08 17:17:13.561036
fda0a376d2084fd7bef52b4b771afcbf,c27368dad75943f0b77e5db348d969d6,2025-03-09,Question girl indeed special west off.,4051.73,Credit,52008.91,,system,2025-06-08 17:17:13.561036,system,2025-06-08 17:17:13.561036
ff53aad9110b43a5bc9ff299a1010ab2,601dfd10cbd741e28471b7414a9b8151,2025-01-08,Others professor cut.,1844.97,Credit,51844.97,,system,2025-06-08 17:17:13.561036,system,2025-06-08 17:17:13.561036
d173c106d1ca4a7aada9203af3897673,601dfd10cbd741e28471b7414a9b8151,2025-02-25,Help lead poor evening section system page American.,-3239.07,Debit,48605.9,,system,2025-06-08 17:17:13.561036,system,2025-06-08 17:17:13.561036
5658eb3eb7014b45ae062f1597ccd483,601dfd10cbd741e28471b7414a9b8151,2025-04-16,Provide woman second rock why thus argue history.,-1175.5,Debit,47430.4,,system,2025-06-08 17:17:13.561036,system,2025-06-08 17:17:13.561036
64fac5f8418049e8a2c36a766c7676fa,601dfd10cbd741e28471b7414a9b8151,2025-06-07,Doctor there section study quality.,-251.61,Debit,47178.79,,system,2025-06-08 17:17:13.561036,system,2025-06-08 17:17:13.561036
6b8409f10f074f33aea4bc791c20fe80,601dfd10cbd741e28471b7414a9b8151,2025-05-07,Result could natural some poor generation.,-1037.85,Debit,46140.94,,system,2025-06-08 17:17:13.561036,system,2025-06-08 17:17:13.561036
9fc8f322f41b4f66b97a1ba8fe0d1c34,601dfd10cbd741e28471b7414a9b8151,2025-05-31,Learn item their audience chair pretty look experience.,3194.07,Credit,49335.01,,system,2025-06-08 17:17:13.561036,system,2025-06-08 17:17:13.561036
a9f8c960ef2a40f589374f30940040f4,601dfd10cbd741e28471b7414a9b8151,2025-05-08,Actually yes course see bad friend.,4711.76,Credit,54046.77,,system,2025-06-08 17:17:13.561036,system,2025-06-08 17:17:13.561036
512cb518916342ae870cd10d0b4905d5,601dfd10cbd741e28471b7414a9b8151,2025-01-09,Bar environment I edge official this official.,3390.02,Credit,57436.79,,system,2025-06-08 17:17:13.561036,system,2025-06-08 17:17:13.561036
566f8f89f403421bb2e3b552b9c899d0,601dfd10cbd741e28471b7414a9b8151,2025-05-28,Type by decision send executive attorney.,-3431.09,Debit,54005.7,,system,2025-06-08 17:17:13.561036,system,2025-06-08 17:17:13.561036
680803a162354215b6c3c81a59c9c3ea,601dfd10cbd741e28471b7414a9b8151,2025-03-09,Never success keep.,-1979.3,Debit,52026.4,,system,2025-06-08 17:17:13.561036,system,2025-06-08 17:17:13.561036
07d6243dcd12414daac2dc7b45647cd1,af8fb436f520499886d518db44b5f483,2025-05-01,Everybody town table fear card film interview.,-4924.1,Debit,45075.9,,system,2025-06-08 17:17:13.561036,system,2025-06-08 17:17:13.561036
f44807e5cc394a568be9c2264e17b215,af8fb436f520499886d518db44b5f483,2025-05-15,Third information career international.,-4549.17,Debit,40526.73,,system,2025-06-08 17:17:13.561036,system,2025-06-08 17:17:13.561036
b09f20fbc7704711b58f63bf3a83301d,af8fb436f520499886d518db44b5f483,2025-05-27,Top least democratic car light middle sea.,1714.24,Credit,42240.97,,system,2025-06-08 17:17:13.561036,system,2025-06-08 17:17:13.561036
f373d59def5f44d89662b2209b077ebf,af8fb436f520499886d518db44b5f483,2025-04-08,Again only really know game project nice act.,-3937.57,Debit,38303.4,,system,2025-06-08 17:17:13.561036,system,2025-06-08 17:17:13.561036
9db6e4704c3145459b0145a87f632af1,af8fb436f520499886d518db44b5f483,2025-04-15,Family crime gas sing certain total fine.,1429.87,Credit,39733.27,,system,2025-06-08 17:17:13.561036,system,2025-06-08 17:17:13.561036
62e231b4f3c7468dace3dc5b39406ed8,af8fb436f520499886d518db44b5f483,2025-04-12,Think can compare land question month treat sort.,-1263.28,Debit,38469.99,,system,2025-06-08 17:17:13.561036,system,2025-06-08 17:17:13.561036
1475744d65534d189e78f671d916353b,af8fb436f520499886d518db44b5f483,2025-02-04,Situation key world left out would laugh.,-105.91,Debit,38364.08,,system,2025-06-08 17:17:13.561036,system,2025-06-08 17:17:13.561036
4a0fba18551c471fb4e135fa0f366964,af8fb436f520499886d518db44b5f483,2025-05-24,Knowledge each give lead change some identify.,-4152.47,Debit,34211.61,,system,2025-06-08 17:17:13.561036,system,2025-06-08 17:17:13.561036
a32de8eebe864868be3431147343c6d2,af8fb436f520499886d518db44b5f483,2024-12-25,Feel into sense hit.,-4979.38,Debit,29232.23,,system,2025-06-08 17:17:13.561036,system,2025-06-08 17:17:13.561036
2129a82a157b4c86b3ce297e887bbcf9,af8fb436f520499886d518db44b5f483,2025-01-11,Draw appear use green push face.,-4783.21,Debit,24449.02,,system,2025-06-08 17:17:13.561036,system,2025-06-08 17:17:13.561036
b5d1429e87634696ba4ef3fd368daf85,dc5a4bc36e0d4efd8e7fd26cf2507512,2025-02-18,Fire theory like bring.,1480.31,Credit,51480.31,,system,2025-06-08 17:17:13.561036,system,2025-06-08 17:17:13.561036
38068094e62c43949a4c9a911624bfdc,dc5a4bc36e0d4efd8e7fd26cf2507512,2025-05-02,System always under well pull feel meeting.,-4005.5,Debit,47474.81,,system,2025-06-08 17:17:13.561036,system,2025-06-08 17:17:13.561036
e6b44197ee13476d88b3dff8d4590ae7,dc5a4bc36e0d4efd8e7fd26cf2507512,2025-03-13,Country future market not citizen effect between.,-3157.94,Debit,44316.87,,system,2025-06-08 17:17:13.561036,system,2025-06-08 17:17:13.561036
3f27ff2e410348b1aff0c28b213603d0,dc5a4bc36e0d4efd8e7fd26cf2507512,2024-12-17,Hour pick report management son.,-1234.27,Debit,43082.6,,system,2025-06-08 17:17:13.561036,system,2025-06-08 17:17:13.561036
aaeb50e998d24ba8b16723fa448e4aba,dc5a4bc36e0d4efd8e7fd26cf2507512,2025-02-02,These serious degree necessary.,-2192.27,Debit,40890.33,,system,2025-06-08 17:17:13.561036,system,2025-06-08 17:17:13.561036
9c91720b3d6b4fee82ed28d4626e9ef9,dc5a4bc36e0d4efd8e7fd26cf2507512,2025-03-06,Finally face experience put.,-4360.1,Debit,36530.23,,system,2025-06-08 17:17:13.561036,system,2025-06-08 17:17:13.561036
c425328c456740c490516a60d9e0a05a,dc5a4bc36e0d4efd8e7fd26cf2507512,2025-01-06,Put brother yes nearly.,-1461.03,Debit,35069.2,,system,2025-06-08 17:17:13.561036,system,2025-06-08 17:17:13.561036
3a1c9397551a4a57a36374e57e9c95bd,dc5a4bc36e0d4efd8e7fd26cf2507512,2025-02-13,Fire both any much executive star peace.,-1908.96,Debit,33160.24,,system,2025-06-08 17:17:13.561036,system,2025-06-08 17:17:13.561036
06004b3fcc2149f2986a146a48863244,dc5a4bc36e0d4efd8e7fd26cf2507512,2024-12-31,There spend road.,793.67,Credit,33953.91,,system,2025-06-08 17:17:13.561036,system,2025-06-08 17:17:13.561036
75b4b6b9ff2f4221b85be3f93a326c0c,dc5a4bc36e0d4efd8e7fd26cf2507512,2025-05-03,Need write pick eight end attack.,3118.95,Credit,37072.86,,system,2025-06-08 17:17:13.561036,system,2025-06-08 17:17:13.561036
c1bbe2d41f67460b8ab232e4cfc20d18,e4655972e1be44718da9601b49aac82b,2025-03-27,Important past surface property support company last.,-2730.96,Debit,47269.04,,system,2025-06-08 17:17:13.561036,system,2025-06-08 17:17:13.561036
c8f85aa4d47344fd95432279bbd2d9e1,e4655972e1be44718da9601b49aac82b,2025-03-12,Once despite speak around.,2939.22,Credit,50208.26,,system,2025-06-08 17:17:13.561036,system,2025-06-08 17:17:13.561036
a7b19da2d5584fcbb89846e165b196c3,e4655972e1be44718da9601b49aac82b,2025-04-14,From decide history could he let.,2269.56,Credit,52477.82,,system,2025-06-08 17:17:13.561036,system,2025-06-08 17:17:13.561036
3e74ec4e2c8f43fdbc962949396ec229,e4655972e1be44718da9601b49aac82b,2025-04-10,Government need white little use through without memory.,-3632.84,Debit,48844.98,,system,2025-06-08 17:17:13.561036,system,2025-06-08 17:17:13.561036
e78398fa5f9545ea972927acedfd1fde,e4655972e1be44718da9601b49aac82b,2025-03-02,Work art author drop service almost why.,-4171.56,Debit,44673.42,,system,2025-06-08 17:17:13.561036,system,2025-06-08 17:17:13.561036
7d2633e417204937a483858cde22f327,e4655972e1be44718da9601b49aac82b,2025-02-09,Tend woman economy edge effort training.,1508.9,Credit,46182.32,,system,2025-06-08 17:17:13.561036,system,2025-06-08 17:17:13.561036
790f043da0bf43dd93a5f78da74b2ca4,e4655972e1be44718da9601b49aac82b,2025-01-23,Describe direction him recognize institution.,-345.27,Debit,45837.05,,system,2025-06-08 17:17:13.561036,system,2025-06-08 17:17:13.561036
993e140ee8e04c34ae66b7ea59997033,e4655972e1be44718da9601b49aac82b,2025-03-28,Floor manage lay PM reach bill box although.,2683.8,Credit,48520.85,,system,2025-06-08 17:17:13.561036,system,2025-06-08 17:17:13.561036
255e719ded64435a91bbdd35ba48553e,e4655972e1be44718da9601b49aac82b,2025-03-26,History chair spring mention see your here.,-1685.02,Debit,46835.83,,system,2025-06-08 17:17:13.561036,system,2025-06-08 17:17:13.561036
964165bc637043a382e46add47fd422a,e4655972e1be44718da9601b49aac82b,2025-03-27,Someone time foot local news perform.,-589.08,Debit,46246.75,,system,2025-06-08 17:17:13.561036,system,2025-06-08 17:17:13.561036
e578b6e234794d4fa2702e32b7f8e7bc,2eb538e48f0d49b3b7cdb72e394032fb,2025-02-15,Hospital require bed first about stay particular past.,3378.67,Credit,53378.67,,system,2025-06-08 17:17:13.561036,system,2025-06-08 17:17:13.561036
2899eafe9a50416c9e2cfa988ae7e919,2eb538e48f0d49b3b7cdb72e394032fb,2025-05-09,Small mouth however mean.,-4871.51,Debit,48507.16,,system,2025-06-08 17:17:13.561036,system,2025-06-08 17:17:13.561036
c2bbf8d9084f454b90c596af9ec9f21a,2eb538e48f0d49b3b7cdb72e394032fb,2025-03-10,Know kind enough.,1149.39,Credit,49656.55,,system,2025-06-08 17:17:13.561036,system,2025-06-08 17:17:13.561036
ea0601ac41e540b9b9c9da6cbabcf781,2eb538e48f0d49b3b7cdb72e394032fb,2025-01-02,Something week heavy.,-3041.88,Debit,46614.67,,system,2025-06-08 17:17:13.561036,system,2025-06-08 17:17:13.561036
62c16f8e811948baa7545afdcd62b89c,2eb538e48f0d49b3b7cdb72e394032fb,2025-05-13,Beyond professional issue operation pick.,1993.0,Credit,48607.67,,system,2025-06-08 17:17:13.561036,system,2025-06-08 17:17:13.561036
d7bee60cb0cf49dcab105f0fa18c391d,2eb538e48f0d49b3b7cdb72e394032fb,2024-12-19,Group Republican allow art care.,4199.97,Credit,52807.64,,system,2025-06-08 17:17:13.561036,system,2025-06-08 17:17:13.561036
db3f209fec2943d39a6453c6f23c2ed7,2eb538e48f0d49b3b7cdb72e394032fb,2025-02-01,Several assume read fill man answer could.,-486.4,Debit,52321.24,,system,2025-06-08 17:17:13.561036,system,2025-06-08 17:17:13.561036
ca1d88cbe476408891b0058207014700,2eb538e48f0d49b3b7cdb72e394032fb,2025-02-21,Begin sister real claim ball soldier.,-720.92,Debit,51600.32,,system,2025-06-08 17:17:13.561036,system,2025-06-08 17:17:13.561036
06ce846dbb4348f284d10948976a2988,2eb538e48f0d49b3b7cdb72e394032fb,2025-03-13,Effort thing good write a nature take education.,2114.98,Credit,53715.3,,system,2025-06-08 17:17:13.561036,system,2025-06-08 17:17:13.561036
3979e584dec547faaf77726f5e53ca16,2eb538e48f0d49b3b7cdb72e394032fb,2025-04-24,Treat or born dream generation.,-4415.87,Debit,49299.43,,system,2025-06-08 17:17:13.561036,system,2025-06-08 17:17:13.561036
0dc32ac3e2ae4de8ab6beb20cd009e8f,7eaef472aa334b3cb25b8eb2289a762c,2024-12-25,Research phone reflect opportunity participant feel.,1588.33,Credit,51588.33,,system,2025-06-08 17:17:13.561036,system,2025-06-08 17:17:13.561036
a95ddd44c268452887d6f6a25b418686,7eaef472aa334b3cb25b8eb2289a762c,2025-02-21,Hair behavior this lead reflect.,3963.31,Credit,55551.64,,system,2025-06-08 17:17:13.561036,system,2025-06-08 17:17:13.561036
fd3c78f39b3046e68b3c54560fada05c,7eaef472aa334b3cb25b8eb2289a762c,2025-06-02,Much leg blood prepare.,-4331.04,Debit,51220.6,,system,2025-06-08 17:17:13.561036,system,2025-06-08 17:17:13.561036
b87bbe93143247f58d1478fbe268555b,7eaef472aa334b3cb25b8eb2289a762c,2025-04-29,Economy start keep chance water conference cup hot.,2837.54,Credit,54058.14,,system,2025-06-08 17:17:13.561036,system,2025-06-08 17:17:13.561036
7ea341a82c174a45b3420753c6ac62b5,7eaef472aa334b3cb25b8eb2289a762c,2024-12-11,Election attorney teach every site world.,537.74,Credit,54595.88,,system,2025-06-08 17:17:13.561036,system,2025-06-08 17:17:13.561036
cd28a77a6dd9429fb071e07d9cdb9e48,7eaef472aa334b3cb25b8eb2289a762c,2025-02-06,Set brother leader course already.,1480.03,Credit,56075.91,,system,2025-06-08 17:17:13.561036,system,2025-06-08 17:17:13.561036
0c11ce0a9f474fe484db02de85485ab7,7eaef472aa334b3cb25b8eb2289a762c,2025-02-24,Occur catch stay economy.,474.4,Credit,56550.31,,system,2025-06-08 17:17:13.561036,system,2025-06-08 17:17:13.561036
4df9b235aad04659b6e8374f66923477,7eaef472aa334b3cb25b8eb2289a762c,2024-12-31,Whom task figure choice director question.,1621.81,Credit,58172.12,,system,2025-06-08 17:17:13.561036,system,2025-06-08 17:17:13.561036
21390f1d461c48f4b18afd6a4fddc3a3,7eaef472aa334b3cb25b8eb2289a762c,2025-05-06,Kind east none explain sing.,-4401.26,Debit,53770.86,,system,2025-06-08 17:17:13.561036,system,2025-06-08 17:17:13.561036
15eea2163d354ecb83361b2ce2cbdd3e,7eaef472aa334b3cb25b8eb2289a762c,2024-12-18,Seek American state Mr alone include nothing upon.,-2540.94,Debit,51229.92,,system,2025-06-08 17:17:13.561036,system,2025-06-08 17:17:13.561036
bbdb3a972ef247a9b6d2726658f80d88,ffbe670c13a0491da52991caced957e8,2025-02-06,Southern become international about never follow yes.,-3861.23,Debit,46138.77,,system,2025-06-08 17:17:13.561036,system,2025-06-08 17:17:13.561036
0b1e76898144486fb6afbafa8ca3085c,ffbe670c13a0491da52991caced957e8,2024-12-16,Of attention trouble computer.,1260.64,Credit,47399.41,,system,2025-06-08 17:17:13.561036,system,2025-06-08 17:17:13.561036
fd7e36bc34644e1db1d3a486879fbd44,ffbe670c13a0491da52991caced957e8,2025-06-02,Role half education policy positive.,4273.61,Credit,51673.02,,system,2025-06-08 17:17:13.561036,system,2025-06-08 17:17:13.561036
3599568a29084d56abac41de53afff31,ffbe670c13a0491da52991caced957e8,2025-02-06,Job trouble difficult service.,-1136.18,Debit,50536.84,,system,2025-06-08 17:17:13.561036,system,2025-06-08 17:17:13.561036
2c06189d00494c82b575ba0168b7f167,ffbe670c13a0491da52991caced957e8,2025-04-17,Too possible speak work.,1326.11,Credit,51862.95,,system,2025-06-08 17:17:13.561036,system,2025-06-08 17:17:13.561036
1f81271671ba43b5bba53f515d9c6ba6,ffbe670c13a0491da52991caced957e8,2025-05-05,Program value society be cost federal.,-1647.0,Debit,50215.95,,system,2025-06-08 17:17:13.561036,system,2025-06-08 17:17:13.561036
89bc092cd9ab40b9977b8d9a2a3fec48,ffbe670c13a0491da52991caced957e8,2024-12-15,Rise though weight film never cultural.,-3488.31,Debit,46727.64,,system,2025-06-08 17:17:13.561036,system,2025-06-08 17:17:13.561036
65d4799bc9f7429b9313b30976fb8621,ffbe670c13a0491da52991caced957e8,2025-01-21,Drop including spring stand house not describe.,-137.06,Debit,46590.58,,system,2025-06-08 17:17:13.561036,system,2025-06-08 17:17:13.561036
d8229bd2661442cca21ca18a31d45ea0,ffbe670c13a0491da52991caced957e8,2025-04-30,Room energy see smile.,-1442.64,Debit,45147.94,,system,2025-06-08 17:17:13.561036,system,2025-06-08 17:17:13.561036
b7b1c9ca57384696ad76c3b6a9c636d3,ffbe670c13a0491da52991caced957e8,2025-05-04,Notice agree assume all seem.,-4283.88,Debit,40864.06,,system,2025-06-08 17:17:13.561036,system,2025-06-08 17:17:13.561036
22ba42a9656b40a3934563016948a58f,ab3d8a07f709454cbb0ba3e387ce246f,2024-12-28,Air the but authority memory safe cultural.,-1214.49,Debit,48785.51,,system,2025-06-08 17:17:13.561036,system,2025-06-08 17:17:13.561036
1add1c673f9046a0ac5548a263e2b77d,ab3d8a07f709454cbb0ba3e387ce246f,2025-03-28,Pressure apply my the.,168.17,Credit,48953.68,,system,2025-06-08 17:17:13.561036,system,2025-06-08 17:17:13.561036
38ddedd3b61547c2bcfffe04d32bb227,ab3d8a07f709454cbb0ba3e387ce246f,2025-03-06,Anyone else hotel research choose only.,1471.22,Credit,50424.9,,system,2025-06-08 17:17:13.561036,system,2025-06-08 17:17:13.561036
dd1e27fbb65845a2822ce1af4859fa3f,ab3d8a07f709454cbb0ba3e387ce246f,2025-02-01,Medical each front which what look according.,-859.15,Debit,49565.75,,system,2025-06-08 17:17:13.561036,system,2025-06-08 17:17:13.561036
e0b4e6be7d42411eac818979ee2e92b8,ab3d8a07f709454cbb0ba3e387ce246f,2025-03-27,Ball and less let.,-4162.12,Debit,45403.63,,system,2025-06-08 17:17:13.561036,system,2025-06-08 17:17:13.561036
43ec7b14f4874bb9ac7d81a843a5abf2,ab3d8a07f709454cbb0ba3e387ce246f,2025-01-04,Leave summer woman establish happy.,3458.03,Credit,48861.66,,system,2025-06-08 17:17:13.561036,system,2025-06-08 17:17:13.561036
104080336a604cc8b60f2ae54511ed8a,ab3d8a07f709454cbb0ba3e387ce246f,2025-06-03,Discover away cold physical scene design case.,-1884.31,Debit,46977.35,,system,2025-06-08 17:17:13.561036,system,2025-06-08 17:17:13.561036
6b38d6a4c709482389bd4f7d77022e33,ab3d8a07f709454cbb0ba3e387ce246f,2025-04-07,My gun customer.,-4599.58,Debit,42377.77,,system,2025-06-08 17:17:13.561036,system,2025-06-08 17:17:13.561036
41701b4a6afa44e09ef5b5daac327911,ab3d8a07f709454cbb0ba3e387ce246f,2025-03-14,Movie hair here position kind where movement.,-464.44,Debit,41913.33,,system,2025-06-08 17:17:13.561036,system,2025-06-08 17:17:13.561036
8c1a1db1b9df4797b8fa1bc646026a44,ab3d8a07f709454cbb0ba3e387ce246f,2025-04-07,At begin trade speech third.,2729.09,Credit,44642.42,,system,2025-06-08 17:17:13.561036,system,2025-06-08 17:17:13.561036
0ad3dea56c6747c3b419c6fc73e4da83,842831195d2d48be99ac179c7cc97c65,2025-01-22,Thing rest a practice paper analysis fact peace.,697.98,Credit,50697.98,,system,2025-06-08 17:17:13.561036,system,2025-06-08 17:17:13.561036
5c296a4d9e8c46159c74f034c06b4edb,842831195d2d48be99ac179c7cc97c65,2024-12-12,Worry concern side popular number let.,645.99,Credit,51343.97,,system,2025-06-08 17:17:13.561036,system,2025-06-08 17:17:13.561036
affa33479762473598b9bdc3d13e63ad,842831195d2d48be99ac179c7cc97c65,2025-04-07,Seat quality lose.,-3514.97,Debit,47829.0,,system,2025-06-08 17:17:13.561036,system,2025-06-08 17:17:13.561036
d564ecc886734046bda4c58072dfb8e4,842831195d2d48be99ac179c7cc97c65,2025-05-21,Learn his wrong past yeah pattern cell risk.,2030.39,Credit,49859.39,,system,2025-06-08 17:17:13.561036,system,2025-06-08 17:17:13.561036
a9968dda1aec402fb008b99af4891ca5,842831195d2d48be99ac179c7cc97c65,2025-04-03,Result ago economy month certainly major.,-2928.21,Debit,46931.18,,system,2025-06-08 17:17:13.561036,system,2025-06-08 17:17:13.561036
0a263647f4504aa295ccffc3086171bb,842831195d2d48be99ac179c7cc97c65,2025-01-06,Authority executive wide fly security nothing set sort.,-626.46,Debit,46304.72,,system,2025-06-08 17:17:13.561036,system,2025-06-08 17:17:13.561036
4c16a25b1c2649aba9b7f00dc614f8d4,842831195d2d48be99ac179c7cc97c65,2025-01-31,Nothing record age identify computer.,1587.06,Credit,47891.78,,system,2025-06-08 17:17:13.561036,system,2025-06-08 17:17:13.561036
64ba99064ce94b478f7182f3d7784285,842831195d2d48be99ac179c7cc97c65,2025-03-03,Attack morning example color middle type could.,3514.57,Credit,51406.35,,system,2025-06-08 17:17:13.561036,system,2025-06-08 17:17:13.561036
117137acb7c34fe6adbe852d76828e24,842831195d2d48be99ac179c7cc97c65,2025-05-07,Business crime top evidence mention young.,1126.06,Credit,52532.41,,system,2025-06-08 17:17:13.561036,system,2025-06-08 17:17:13.561036
79d4f71a13c942d081ca4e3e50f628cd,842831195d2d48be99ac179c7cc97c65,2025-01-22,Series party common kid.,4708.99,Credit,57241.4,,system,2025-06-08 17:17:13.561036,system,2025-06-08 17:17:13.561036
3f4f1557f8ac44fd9da2ab6b1465ee8b,006e2bc459af4f948c641488829cf151,2025-05-13,Community bank smile money control bed despite girl.,2136.06,Credit,52136.06,,system,2025-06-08 17:17:13.561036,system,2025-06-08 17:17:13.561036
34350a89c2e749b8a67d03ddd6f7da01,006e2bc459af4f948c641488829cf151,2025-01-18,Coach may crime yourself major here.,-91.11,Debit,52044.95,,system,2025-06-08 17:17:13.561036,system,2025-06-08 17:17:13.561036
7c9191f4449541f2a1260567157ea319,006e2bc459af4f948c641488829cf151,2024-12-16,View design black first listen mean less address.,-2982.95,Debit,49062.0,,system,2025-06-08 17:17:13.561036,system,2025-06-08 17:17:13.561036
00800a270ff84659b3560f0253c5f8b3,006e2bc459af4f948c641488829cf151,2025-03-13,Be edge source certainly since arm.,-30.68,Debit,49031.32,,system,2025-06-08 17:17:13.561036,system,2025-06-08 17:17:13.561036
f8efa07aae144bbfa93ef532fb92e079,006e2bc459af4f948c641488829cf151,2025-03-13,Store pick anyone various.,701.25,Credit,49732.57,,system,2025-06-08 17:17:13.561036,system,2025-06-08 17:17:13.561036
d0c802e6fdc44e9297950bbd1256825e,006e2bc459af4f948c641488829cf151,2025-01-25,Eye condition skin car accept late identify.,3955.17,Credit,53687.74,,system,2025-06-08 17:17:13.561036,system,2025-06-08 17:17:13.561036
ab09633d47984e15a258a1483547db9e,006e2bc459af4f948c641488829cf151,2025-05-15,Throughout identify try defense reflect.,-3605.39,Debit,50082.35,,system,2025-06-08 17:17:13.561036,system,2025-06-08 17:17:13.561036
24fedca66f29468d9f9d69465f8357a3,006e2bc459af4f948c641488829cf151,2025-03-30,Role street reveal agency be room.,-4016.38,Debit,46065.97,,system,2025-06-08 17:17:13.561036,system,2025-06-08 17:17:13.561036
d4474011e0a1448281c816fe345bb3ae,006e2bc459af4f948c641488829cf151,2025-06-01,Body institution simply mother apply sometimes.,1672.99,Credit,47738.96,,system,2025-06-08 17:17:13.561036,system,2025-06-08 17:17:13.561036
63fb8e8cde974a4cbc5e9634cb1fe748,006e2bc459af4f948c641488829cf151,2025-03-10,Especially break hot.,3145.25,Credit,50884.21,,system,2025-06-08 17:17:13.561036,system,2025-06-08 17:17:13.561036
2dfcf892b8fc464687a06a779e13e9e1,9f85cfe3c9bb425882735e33bb999f8f,2025-02-19,Marriage third hope own.,-3363.33,Debit,46636.67,,system,2025-06-08 17:17:13.561036,system,2025-06-08 17:17:13.561036
0f74c1e1b93541809cd8fcde96082959,9f85cfe3c9bb425882735e33bb999f8f,2025-04-22,Environmental plan edge happy table necessary support if.,-1070.81,Debit,45565.86,,system,2025-06-08 17:17:13.561036,system,2025-06-08 17:17:13.561036
11931970d6d049ab93fec78adfeda415,9f85cfe3c9bb425882735e33bb999f8f,2025-04-13,Marriage important expert.,-689.17,Debit,44876.69,,system,2025-06-08 17:17:13.561036,system,2025-06-08 17:17:13.561036
8f153bf00ac54d9cace4ae644a72339f,9f85cfe3c9bb425882735e33bb999f8f,2025-03-06,Surface evidence arm everybody natural.,3715.05,Credit,48591.74,,system,2025-06-08 17:17:13.561036,system,2025-06-08 17:17:13.561036
4d65b3e30e3f45b994e0194339304853,9f85cfe3c9bb425882735e33bb999f8f,2025-05-03,People throw yes major outside feeling.,-4363.86,Debit,44227.88,,system,2025-06-08 17:17:13.561036,system,2025-06-08 17:17:13.561036
6569da50de78405c93a3b98627161fe5,9f85cfe3c9bb425882735e33bb999f8f,2025-03-29,Result size public.,-121.48,Debit,44106.4,,system,2025-06-08 17:17:13.561036,system,2025-06-08 17:17:13.561036
9d2d0c2adce649d58864b809d51c35b8,9f85cfe3c9bb425882735e33bb999f8f,2025-03-12,Exactly both study.,-1840.77,Debit,42265.63,,system,2025-06-08 17:17:13.561036,system,2025-06-08 17:17:13.561036
3a17729800fc4c7fae5544dbb45f85de,9f85cfe3c9bb425882735e33bb999f8f,2025-04-06,Try call probably between alone town.,-2793.93,Debit,39471.7,,system,2025-06-08 17:17:13.561036,system,2025-06-08 17:17:13.561036
8861c5eae74941ec893723d7db0f6643,9f85cfe3c9bb425882735e33bb999f8f,2025-03-07,Wide how career action rule always.,-109.91,Debit,39361.79,,system,2025-06-08 17:17:13.561036,system,2025-06-08 17:17:13.561036
b9882b17269746deb5c6db3f56a9d311,9f85cfe3c9bb425882735e33bb999f8f,2025-03-20,Item resource according other child whatever.,1726.41,Credit,41088.2,,system,2025-06-08 17:17:13.561036,system,2025-06-08 17:17:13.561036
06c8e6fe331d47ee9bffc7d6e3585901,f68cff0656154b4fb04df4377fa6a782,2025-03-02,Market only reduce factor.,4303.52,Credit,54303.52,,system,2025-06-08 17:17:13.561036,system,2025-06-08 17:17:13.561036
9aca8aed84e44db6a1a918066e79e093,f68cff0656154b4fb04df4377fa6a782,2025-02-23,Surface sit deal throw strong oil upon.,1135.95,Credit,55439.47,,system,2025-06-08 17:17:13.561036,system,2025-06-08 17:17:13.561036
f86e1baf67eb45a8822c6c492eb225ee,f68cff0656154b4fb04df4377fa6a782,2025-02-16,Into for light their drug learn record.,-2398.22,Debit,53041.25,,system,2025-06-08 17:17:13.561036,system,2025-06-08 17:17:13.561036
9dfafb63058144bda014a4b1889dce0a,f68cff0656154b4fb04df4377fa6a782,2025-01-09,Debate tough few seem new commercial stuff per.,113.09,Credit,53154.34,,system,2025-06-08 17:17:13.561036,system,2025-06-08 17:17:13.561036
d77e522339a848f7bbaf047df036ffe9,f68cff0656154b4fb04df4377fa6a782,2025-04-27,Put person church suggest join blue garden.,-741.4,Debit,52412.94,,system,2025-06-08 17:17:13.561036,system,2025-06-08 17:17:13.561036
a969a300f8854bb79922bbfac93ac5a2,f68cff0656154b4fb04df4377fa6a782,2025-01-12,Color college success you model far.,-2213.18,Debit,50199.76,,system,2025-06-08 17:17:13.561036,system,2025-06-08 17:17:13.561036
097189771f134996ba236eff105b7115,f68cff0656154b4fb04df4377fa6a782,2025-03-06,Lawyer believe gun cut make chair thus talk.,-2120.21,Debit,48079.55,,system,2025-06-08 17:17:13.561036,system,2025-06-08 17:17:13.561036
104619d3de3a436f89b756be5d3fbcd2,f68cff0656154b4fb04df4377fa6a782,2025-06-03,Food share while account sister dog.,3304.61,Credit,51384.16,,system,2025-06-08 17:17:13.561036,system,2025-06-08 17:17:13.561036
257ca7e970644310b9bf747584f832f8,f68cff0656154b4fb04df4377fa6a782,2024-12-30,Idea stay good truth.,-1931.73,Debit,49452.43,,system,2025-06-08 17:17:13.561036,system,2025-06-08 17:17:13.561036
fd43795cdb804cd18bafb0c356649bf9,f68cff0656154b4fb04df4377fa6a782,2025-06-07,Catch speak learn sound different choice.,-3619.1,Debit,45833.33,,system,2025-06-08 17:17:13.561036,system,2025-06-08 17:17:13.561036
a2314ca871bb4562ad8c7ff2bf354563,459e2d85e2224330b060e4a2904bc589,2025-01-11,Race eight heart skin type moment.,4585.74,Credit,54585.74,,system,2025-06-08 17:17:13.561036,system,2025-06-08 17:17:13.561036
f4f4c67cac6c4cab8d1a6156a35380b8,459e2d85e2224330b060e4a2904bc589,2025-01-14,Somebody stop prove understand policy.,-3703.86,Debit,50881.88,,system,2025-06-08 17:17:13.561036,system,2025-06-08 17:17:13.561036
f474d05ee5b54d56a0f57515e8ae3263,459e2d85e2224330b060e4a2904bc589,2025-03-02,Hold example trade opportunity magazine doctor indicate manager.,-811.93,Debit,50069.95,,system,2025-06-08 17:17:13.561036,system,2025-06-08 17:17:13.561036
149f59f111744be4997eaee9b80377d2,459e2d85e2224330b060e4a2904bc589,2025-03-15,Great man where top.,338.32,Credit,50408.27,,system,2025-06-08 17:17:13.561036,system,2025-06-08 17:17:13.561036
d422446faa1548aea2a23dd1b1832928,459e2d85e2224330b060e4a2904bc589,2025-05-03,List skill if remember.,3587.48,Credit,53995.75,,system,2025-06-08 17:17:13.561036,system,2025-06-08 17:17:13.561036
2464fe31bc5d4c9e8eb682b5f02f8ec4,459e2d85e2224330b060e4a2904bc589,2025-05-26,Help road north.,3184.23,Credit,57179.98,,system,2025-06-08 17:17:13.561036,system,2025-06-08 17:17:13.561036
f5e8786264b247b6ae88b09d1d22d03e,459e2d85e2224330b060e4a2904bc589,2025-05-07,Chance method they partner.,3663.68,Credit,60843.66,,system,2025-06-08 17:17:13.561036,system,2025-06-08 17:17:13.561036
83e05c2629da413b8e88e864f0e5dde3,459e2d85e2224330b060e4a2904bc589,2025-02-22,Each wind officer choose.,2506.94,Credit,63350.6,,system,2025-06-08 17:17:13.561036,system,2025-06-08 17:17:13.561036
808bfb4a51d242e4816f01e3b9e03602,459e2d85e2224330b060e4a2904bc589,2025-04-24,National minute voice way strong.,2109.62,Credit,65460.22,,system,2025-06-08 17:17:13.561036,system,2025-06-08 17:17:13.561036
1b534ee9e8ec44e192b4bbe24cc76718,459e2d85e2224330b060e4a2904bc589,2025-04-10,Garden face despite.,972.77,Credit,66432.99,,system,2025-06-08 17:17:13.561036,system,2025-06-08 17:17:13.561036
e47939eb86ae4f4191cbe6a28ea49fbf,d26bb4dad1234e8cb5ae9a95a6612b0e,2024-12-11,South strategy concern financial cultural.,2396.95,Credit,52396.95,,system,2025-06-08 17:17:13.561036,system,2025-06-08 17:17:13.561036
60cffed1811e40fa9d38adf51702df9f,d26bb4dad1234e8cb5ae9a95a6612b0e,2025-02-16,Go should open both.,-4782.15,Debit,47614.8,,system,2025-06-08 17:17:13.561036,system,2025-06-08 17:17:13.561036
43ef1d9e4a504c339a5ce2709efed1d5,d26bb4dad1234e8cb5ae9a95a6612b0e,2025-04-14,Personal relationship occur four deep.,843.07,Credit,48457.87,,system,2025-06-08 17:17:13.561036,system,2025-06-08 17:17:13.561036
0e8739d136b1406fb63c5f3cddc575d3,d26bb4dad1234e8cb5ae9a95a6612b0e,2025-04-01,Black else police structure.,-2425.99,Debit,46031.88,,system,2025-06-08 17:17:13.561036,system,2025-06-08 17:17:13.561036
086a5d37c0f04e4db63f743c0da4f731,d26bb4dad1234e8cb5ae9a95a6612b0e,2025-05-21,Near represent over trip.,3664.73,Credit,49696.61,,system,2025-06-08 17:17:13.561036,system,2025-06-08 17:17:13.561036
8b79570dd1d14742bdd950845b2501a4,d26bb4dad1234e8cb5ae9a95a6612b0e,2025-05-11,Clear radio close win.,-3690.1,Debit,46006.51,,system,2025-06-08 17:17:13.561036,system,2025-06-08 17:17:13.561036
2d13b8bc2f70449fb506461ea2182289,d26bb4dad1234e8cb5ae9a95a6612b0e,2024-12-22,Represent themselves economy hope score vote.,-1988.38,Debit,44018.13,,system,2025-06-08 17:17:13.561036,system,2025-06-08 17:17:13.561036
485f3efd564a43b6aa089293432f0e0f,d26bb4dad1234e8cb5ae9a95a6612b0e,2025-06-07,Offer away side though sense return certainly.,-1287.52,Debit,42730.61,,system,2025-06-08 17:17:13.561036,system,2025-06-08 17:17:13.561036
c3ab2913d97e4dd284023b870d4738af,d26bb4dad1234e8cb5ae9a95a6612b0e,2025-04-19,Response relate care moment budget.,-3139.54,Debit,39591.07,,system,2025-06-08 17:17:13.561036,system,2025-06-08 17:17:13.561036
c1b016bfa914491fb4a8d73be493e8c3,d26bb4dad1234e8cb5ae9a95a6612b0e,2025-02-02,Focus strong up order.,-2072.93,Debit,37518.14,,system,2025-06-08 17:17:13.561036,system,2025-06-08 17:17:13.561036
a61b1075289547168aed91226a039910,04c1b8d3cef44ffe94ff2228b891415b,2024-12-14,Ask help return another meet simple.,-385.31,Debit,49614.69,,system,2025-06-08 17:17:13.561036,system,2025-06-08 17:17:13.561036
b2d7eb70ba1d4b0e8994263e1538c339,04c1b8d3cef44ffe94ff2228b891415b,2024-12-11,Tv result nearly top security.,4349.18,Credit,53963.87,,system,2025-06-08 17:17:13.561036,system,2025-06-08 17:17:13.561036
c8c67546f6b749f8adf29751694c405d,04c1b8d3cef44ffe94ff2228b891415b,2024-12-12,Tend prepare answer always.,1681.3,Credit,55645.17,,system,2025-06-08 17:17:13.561036,system,2025-06-08 17:17:13.561036
04c183422e4c4284a8248060ad36b823,04c1b8d3cef44ffe94ff2228b891415b,2025-03-12,Marriage worker past organization own unit.,-4937.48,Debit,50707.69,,system,2025-06-08 17:17:13.561036,system,2025-06-08 17:17:13.561036
d0dfa4281d6b4926bca4a709dc8ef93f,04c1b8d3cef44ffe94ff2228b891415b,2025-01-14,Above crime evening.,4724.66,Credit,55432.35,,system,2025-06-08 17:17:13.561036,system,2025-06-08 17:17:13.561036
ae8d3ec6c47244bb856b5be56a331d87,04c1b8d3cef44ffe94ff2228b891415b,2025-05-04,Network far town boy.,-363.59,Debit,55068.76,,system,2025-06-08 17:17:13.561036,system,2025-06-08 17:17:13.561036
06b1a54ebfa24280b5cf42c902f28ae5,04c1b8d3cef44ffe94ff2228b891415b,2025-01-26,Field face rock moment.,-1264.2,Debit,53804.56,,system,2025-06-08 17:17:13.561036,system,2025-06-08 17:17:13.561036
3209e33f55a54cc8a29f4f10d054d9f7,04c1b8d3cef44ffe94ff2228b891415b,2024-12-23,Door rule memory right.,-2086.93,Debit,51717.63,,system,2025-06-08 17:17:13.561036,system,2025-06-08 17:17:13.561036
51994e09c2a64001aba7b3519ef1c0f6,04c1b8d3cef44ffe94ff2228b891415b,2025-06-02,Summer member weight.,-4480.6,Debit,47237.03,,system,2025-06-08 17:17:13.561036,system,2025-06-08 17:17:13.561036
c236ab37fbd4436699d8d6b275bb8152,04c1b8d3cef44ffe94ff2228b891415b,2024-12-24,Identify time write picture morning.,-2963.88,Debit,44273.15,,system,2025-06-08 17:17:13.561036,system,2025-06-08 17:17:13.561036
e1c92af0c0f54c758986c86fca7ee0b2,47eec58a56c24feb936822cebf2aa3f1,2025-05-05,Hotel shake near area.,1109.64,Credit,51109.64,,system,2025-06-08 17:17:13.561036,system,2025-06-08 17:17:13.561036
c7ab96b18a254aa195c4602a298d9203,47eec58a56c24feb936822cebf2aa3f1,2025-02-13,Force market join happen something tend attack.,-4063.93,Debit,47045.71,,system,2025-06-08 17:17:13.561036,system,2025-06-08 17:17:13.561036
e865a0c5e3d24e8fbcef4bc92a194b74,47eec58a56c24feb936822cebf2aa3f1,2025-05-03,Then unit finish west security area exactly happy.,555.01,Credit,47600.72,,system,2025-06-08 17:17:13.561036,system,2025-06-08 17:17:13.561036
d161ed8ee8184735bcfbfbf13cdd0bf7,47eec58a56c24feb936822cebf2aa3f1,2025-04-20,Now enter eye center about price.,2741.71,Credit,50342.43,,system,2025-06-08 17:17:13.561036,system,2025-06-08 17:17:13.561036
7d5751a0692842d48b856916f6beb586,47eec58a56c24feb936822cebf2aa3f1,2025-04-30,Series grow race like part.,-552.93,Debit,49789.5,,system,2025-06-08 17:17:13.561036,system,2025-06-08 17:17:13.561036
e6160cb00bb946f9868aca4a163af1e7,47eec58a56c24feb936822cebf2aa3f1,2025-01-14,Return list another rise.,1934.16,Credit,51723.66,,system,2025-06-08 17:17:13.561036,system,2025-06-08 17:17:13.561036
17f0a53978d0476eb9ea394292204b01,47eec58a56c24feb936822cebf2aa3f1,2025-03-31,Foreign myself woman fill do I whatever single.,1987.17,Credit,53710.83,,system,2025-06-08 17:17:13.561036,system,2025-06-08 17:17:13.561036
f24f9f48178546eea95e21564905f2c9,47eec58a56c24feb936822cebf2aa3f1,2025-02-27,Impact major choose must fact keep political.,-1833.44,Debit,51877.39,,system,2025-06-08 17:17:13.561036,system,2025-06-08 17:17:13.561036
1698f6d78087468fb96374307bccfc2e,47eec58a56c24feb936822cebf2aa3f1,2025-02-15,Draw four nation dark wall position bill.,-117.62,Debit,51759.77,,system,2025-06-08 17:17:13.561036,system,2025-06-08 17:17:13.561036
754afa809ec744399621411095479630,47eec58a56c24feb936822cebf2aa3f1,2025-04-19,Now program property respond resource building start.,-4882.49,Debit,46877.28,,system,2025-06-08 17:17:13.561036,system,2025-06-08 17:17:13.561036
72080110e08c4abf9014e419595180da,d752343f8a214a59b35640a96e26e374,2025-04-13,Benefit floor claim office physical happy writer.,-930.04,Debit,49069.96,,system,2025-06-08 17:17:13.561036,system,2025-06-08 17:17:13.561036
bd5633e2ac6b4e9297622ecf98c3adab,d752343f8a214a59b35640a96e26e374,2025-01-26,Recently garden they yourself however.,1709.02,Credit,50778.98,,system,2025-06-08 17:17:13.561036,system,2025-06-08 17:17:13.561036
0ce1a48279c74cddbaa481e841c6edd3,d752343f8a214a59b35640a96e26e374,2025-06-07,Represent final scene.,-736.61,Debit,50042.37,,system,2025-06-08 17:17:13.561036,system,2025-06-08 17:17:13.561036
cf1bb7febdcd420cb8b10b1ae0b0de56,d752343f8a214a59b35640a96e26e374,2025-05-04,Contain student fly most arrive.,-3871.76,Debit,46170.61,,system,2025-06-08 17:17:13.561036,system,2025-06-08 17:17:13.561036
2f8bcde5637d471792535eecc3f0c35e,d752343f8a214a59b35640a96e26e374,2025-05-01,Sort less music page movement decade three.,3832.81,Credit,50003.42,,system,2025-06-08 17:17:13.561036,system,2025-06-08 17:17:13.561036
2ac51d28a5be4e33bc9d2c091dbb541b,d752343f8a214a59b35640a96e26e374,2025-05-27,Base tend paper situation.,-4729.33,Debit,45274.09,,system,2025-06-08 17:17:13.561036,system,2025-06-08 17:17:13.561036
dd979a5d595748f789fa84dce149a2de,d752343f8a214a59b35640a96e26e374,2024-12-17,Last business better product north.,3913.41,Credit,49187.5,,system,2025-06-08 17:17:13.561036,system,2025-06-08 17:17:13.561036
92fd42e1655b43469b07b4987714788c,d752343f8a214a59b35640a96e26e374,2025-01-31,Between together evening else support require.,179.92,Credit,49367.42,,system,2025-06-08 17:17:13.561036,system,2025-06-08 17:17:13.561036
2996f058b5f8492cae4e0bd3ce80878a,d752343f8a214a59b35640a96e26e374,2025-05-07,Prevent health table seven.,4181.06,Credit,53548.48,,system,2025-06-08 17:17:13.561036,system,2025-06-08 17:17:13.561036
41562535019d41d8959375f537da5903,d752343f8a214a59b35640a96e26e374,2025-04-05,Vote old official tend result.,-1123.02,Debit,52425.46,,system,2025-06-08 17:17:13.561036,system,2025-06-08 17:17:13.561036
93c56c37ba2a4c7ab0c8f9ae03cbdd11,9b1a176fc9764ea4b6c1f1ee60a680ee,2025-01-20,Fine which somebody television investment across.,2732.35,Credit,52732.35,,system,2025-06-08 17:17:13.561036,system,2025-06-08 17:17:13.561036
fedda7f777424c77ae20f15260405d1f,9b1a176fc9764ea4b6c1f1ee60a680ee,2025-04-15,Military week material activity entire people health.,-2964.6,Debit,49767.75,,system,2025-06-08 17:17:13.561036,system,2025-06-08 17:17:13.561036
72bdab54ecdf4e5383c35e264eafa0eb,9b1a176fc9764ea4b6c1f1ee60a680ee,2025-02-13,Cold quickly size region these consumer.,-771.4,Debit,48996.35,,system,2025-06-08 17:17:13.561036,system,2025-06-08 17:17:13.561036
3ab6fa6bd39f46e08d82e66a6da3649c,9b1a176fc9764ea4b6c1f1ee60a680ee,2025-03-03,Special reduce region mother environmental top.,1756.95,Credit,50753.3,,system,2025-06-08 17:17:13.561036,system,2025-06-08 17:17:13.561036
4a4903818104460ab57c86a9ef0a08ba,9b1a176fc9764ea4b6c1f1ee60a680ee,2025-01-29,Event green approach newspaper home require.,-4770.59,Debit,45982.71,,system,2025-06-08 17:17:13.561036,system,2025-06-08 17:17:13.561036
81ec655f0f774a159ff8118413b0dc9a,9b1a176fc9764ea4b6c1f1ee60a680ee,2024-12-14,Training including cold company technology plant on.,-3336.14,Debit,42646.57,,system,2025-06-08 17:17:13.561036,system,2025-06-08 17:17:13.561036
e1fc9a692e1843fda809b7d2a73066da,9b1a176fc9764ea4b6c1f1ee60a680ee,2025-02-25,Wife than interesting organization.,402.57,Credit,43049.14,,system,2025-06-08 17:17:13.561036,system,2025-06-08 17:17:13.561036
53c384e0a83d450fb9c0ceba7849b83b,9b1a176fc9764ea4b6c1f1ee60a680ee,2024-12-27,Book thus single to hard.,-12.35,Debit,43036.79,,system,2025-06-08 17:17:13.561036,system,2025-06-08 17:17:13.561036
1c310236185d44c1b744188c6246b809,9b1a176fc9764ea4b6c1f1ee60a680ee,2025-04-17,Reduce responsibility ever interview material.,-4142.06,Debit,38894.73,,system,2025-06-08 17:17:13.561036,system,2025-06-08 17:17:13.561036
c4042c6bd2a140359b485f969e4fd266,9b1a176fc9764ea4b6c1f1ee60a680ee,2025-03-15,Check table art radio employee minute rise.,-1188.09,Debit,37706.64,,system,2025-06-08 17:17:13.561036,system,2025-06-08 17:17:13.561036
68aff6fb66e04594987f4b2cf3f2c520,727b6b48a8d94610bab1003ea690bfd4,2025-04-05,Sound media economic professional campaign.,1401.15,Credit,51401.15,,system,2025-06-08 17:17:13.561036,system,2025-06-08 17:17:13.561036
4c3489881ec54d6fa1095c52ea8ce034,727b6b48a8d94610bab1003ea690bfd4,2025-03-27,May receive idea effect visit.,1065.9,Credit,52467.05,,system,2025-06-08 17:17:13.561036,system,2025-06-08 17:17:13.561036
98dcae992b9c44009ae02d0266721a88,727b6b48a8d94610bab1003ea690bfd4,2025-01-06,Thing knowledge manager.,3906.53,Credit,56373.58,,system,2025-06-08 17:17:13.561036,system,2025-06-08 17:17:13.561036
41f555736bfa4f339b1e1d211d1d0486,727b6b48a8d94610bab1003ea690bfd4,2025-01-16,Industry wind however arrive close development.,-3669.19,Debit,52704.39,,system,2025-06-08 17:17:13.561036,system,2025-06-08 17:17:13.561036
51516a00c88c4b52b47bcf3e52294835,727b6b48a8d94610bab1003ea690bfd4,2025-02-21,Finish believe popular able whose perhaps police dream.,4853.72,Credit,57558.11,,system,2025-06-08 17:17:13.561036,system,2025-06-08 17:17:13.561036
570037e02d4b4fc5b5fb2b676dfd2853,727b6b48a8d94610bab1003ea690bfd4,2025-05-26,Probably necessary miss attorney start.,-2200.68,Debit,55357.43,,system,2025-06-08 17:17:13.561036,system,2025-06-08 17:17:13.561036
bcd568393752477abeafdd177908ca13,727b6b48a8d94610bab1003ea690bfd4,2025-04-21,Power address second any country.,-3862.75,Debit,51494.68,,system,2025-06-08 17:17:13.561036,system,2025-06-08 17:17:13.561036
0cb86335cfe2406496cdff7d68375579,727b6b48a8d94610bab1003ea690bfd4,2024-12-31,Particular entire seven speak end chance just.,-3544.29,Debit,47950.39,,system,2025-06-08 17:17:13.561036,system,2025-06-08 17:17:13.561036
d4f7645c98574512a91d245294aae432,727b6b48a8d94610bab1003ea690bfd4,2025-05-16,Head realize sense site later.,-1304.09,Debit,46646.3,,system,2025-06-08 17:17:13.561036,system,2025-06-08 17:17:13.561036
9d44ced81d6d48a2bf7424d99d10801b,727b6b48a8d94610bab1003ea690bfd4,2025-04-14,Idea once really pay this sort cold.,4080.97,Credit,50727.27,,system,2025-06-08 17:17:13.561036,system,2025-06-08 17:17:13.561036
20985ff5b45b4ba1b57253c1eaa73263,ef8eafef31374319af4c1a063b8d253b,2024-12-23,Training activity seek management.,-1258.0,Debit,48742.0,,system,2025-06-08 17:17:13.561036,system,2025-06-08 17:17:13.561036
c799ea5238c54754ab4148ab0290a188,ef8eafef31374319af4c1a063b8d253b,2025-06-08,Low yeah who send.,4691.23,Credit,53433.23,,system,2025-06-08 17:17:13.561036,system,2025-06-08 17:17:13.561036
f0a0898317c24582b44ee8adad13a3cd,ef8eafef31374319af4c1a063b8d253b,2025-03-16,Debate reality discuss.,-4225.55,Debit,49207.68,,system,2025-06-08 17:17:13.561036,system,2025-06-08 17:17:13.561036
e2a28ab1ce26410f984b273ccd0d60f9,ef8eafef31374319af4c1a063b8d253b,2025-05-11,Usually Mrs president action question.,-2082.26,Debit,47125.42,,system,2025-06-08 17:17:13.561036,system,2025-06-08 17:17:13.561036
b2666fd43f064db9b752f8304b3b7a2b,ef8eafef31374319af4c1a063b8d253b,2025-01-24,Far response travel because even our.,-248.07,Debit,46877.35,,system,2025-06-08 17:17:13.561036,system,2025-06-08 17:17:13.561036
e0f42e0d27b24892bbb8423033d759df,ef8eafef31374319af4c1a063b8d253b,2024-12-26,Place floor think process red nor.,2153.95,Credit,49031.3,,system,2025-06-08 17:17:13.561036,system,2025-06-08 17:17:13.561036
45bfd9d0b3f449b186e0b76406908a48,ef8eafef31374319af4c1a063b8d253b,2025-05-27,East nice best all when.,-4399.86,Debit,44631.44,,system,2025-06-08 17:17:13.561036,system,2025-06-08 17:17:13.561036
1c4a8504bdd544508b8280711439c79c,ef8eafef31374319af4c1a063b8d253b,2025-01-25,Make report any condition source cause.,-2832.63,Debit,41798.81,,system,2025-06-08 17:17:13.561036,system,2025-06-08 17:17:13.561036
a2b77cfea68a427082c6898dd8122da1,ef8eafef31374319af4c1a063b8d253b,2025-01-12,Until old herself become individual.,2337.48,Credit,44136.29,,system,2025-06-08 17:17:13.561036,system,2025-06-08 17:17:13.561036
488a63d2f41e44ad9adf32807dc6c560,ef8eafef31374319af4c1a063b8d253b,2025-05-30,So begin the.,1389.22,Credit,45525.51,,system,2025-06-08 17:17:13.561036,system,2025-06-08 17:17:13.561036
e57841a57d9a41f98b6d7d5c735c9104,7710d4b13a9a4ef79fb17796d2266c2f,2024-12-27,Expert maybe push throw able.,-2141.59,Debit,47858.41,,system,2025-06-08 17:17:13.572548,system,2025-06-08 17:17:13.572548
b106b6fa5377458caa271e4c4615ab4f,7710d4b13a9a4ef79fb17796d2266c2f,2025-03-28,Table race yet happy possible occur.,-4318.62,Debit,43539.79,,system,2025-06-08 17:17:13.572548,system,2025-06-08 17:17:13.572548
a9ee2e29e4eb4944bd632b30899caec9,7710d4b13a9a4ef79fb17796d2266c2f,2025-04-08,Little pick edge machine.,-4385.64,Debit,39154.15,,system,2025-06-08 17:17:13.573057,system,2025-06-08 17:17:13.573057
f7762fc95ab84b719e467ab7bfadd5df,7710d4b13a9a4ef79fb17796d2266c2f,2025-02-25,Many energy serious head.,-4361.26,Debit,34792.89,,system,2025-06-08 17:17:13.573057,system,2025-06-08 17:17:13.573057
80dbed5f6d114a0b8dff9ff17a1c8e2a,7710d4b13a9a4ef79fb17796d2266c2f,2025-01-29,Guess debate together president dark power compare the.,-1150.38,Debit,33642.51,,system,2025-06-08 17:17:13.573057,system,2025-06-08 17:17:13.573057
13f7e3c88ec74a38bfd7cf6b535612bb,7710d4b13a9a4ef79fb17796d2266c2f,2024-12-15,Air impact begin big rich.,-1600.7,Debit,32041.81,,system,2025-06-08 17:17:13.573057,system,2025-06-08 17:17:13.573057
7d255fa665cc4477b79bf9159969a36d,7710d4b13a9a4ef79fb17796d2266c2f,2025-03-16,Opportunity leave those sell.,-2864.23,Debit,29177.58,,system,2025-06-08 17:17:13.573057,system,2025-06-08 17:17:13.573057
abd34f355cc7421ba5c45725c2181743,7710d4b13a9a4ef79fb17796d2266c2f,2024-12-28,Cut respond my somebody.,-3090.68,Debit,26086.9,,system,2025-06-08 17:17:13.573057,system,2025-06-08 17:17:13.573057
9b5e24145c454d3a8b6637b26e29ed38,7710d4b13a9a4ef79fb17796d2266c2f,2025-03-30,Control site personal position.,1545.3,Credit,27632.2,,system,2025-06-08 17:17:13.573057,system,2025-06-08 17:17:13.573057
1ef9b16d1c6443ffad9e10eecd1af009,7710d4b13a9a4ef79fb17796d2266c2f,2025-04-14,Answer effect state them crime food wait.,150.52,Credit,27782.72,,system,2025-06-08 17:17:13.573057,system,2025-06-08 17:17:13.573057
adc210d6622e4c908ae8ef5c7fbd6e2c,6cfd605734e64c0cbfe3cfdb6f1a1afd,2025-02-11,Million air change maybe experience.,-226.88,Debit,49773.12,,system,2025-06-08 17:17:13.573057,system,2025-06-08 17:17:13.573057
c782ae9d218f42e29072115ec171b072,6cfd605734e64c0cbfe3cfdb6f1a1afd,2025-01-30,Open maintain onto reflect group dream.,-1802.81,Debit,47970.31,,system,2025-06-08 17:17:13.573057,system,2025-06-08 17:17:13.573057
136363604acd434cbce055b2a630cef7,6cfd605734e64c0cbfe3cfdb6f1a1afd,2025-05-29,Piece they should visit what.,-4500.61,Debit,43469.7,,system,2025-06-08 17:17:13.573057,system,2025-06-08 17:17:13.573057
9bf9e970fc4f40c9ba6b356c11ed9afc,6cfd605734e64c0cbfe3cfdb6f1a1afd,2025-06-05,He business himself support thousand.,1244.65,Credit,44714.35,,system,2025-06-08 17:17:13.573057,system,2025-06-08 17:17:13.573057
4086ad46aede475b93f489235ff8121a,6cfd605734e64c0cbfe3cfdb6f1a1afd,2025-02-25,But eye fact western candidate suddenly.,-3968.91,Debit,40745.44,,system,2025-06-08 17:17:13.573057,system,2025-06-08 17:17:13.573057
058fc857dae44e6784dba3ec6a29422f,6cfd605734e64c0cbfe3cfdb6f1a1afd,2025-03-19,Region hundred experience event story.,163.2,Credit,40908.64,,system,2025-06-08 17:17:13.573057,system,2025-06-08 17:17:13.573057
967a6c48d0c0471fb7fe49b3be35de06,6cfd605734e64c0cbfe3cfdb6f1a1afd,2025-02-14,Blue first each.,-1185.67,Debit,39722.97,,system,2025-06-08 17:17:13.573057,system,2025-06-08 17:17:13.573057
d926218e0bb042a492f0a6642a50b91c,6cfd605734e64c0cbfe3cfdb6f1a1afd,2025-02-13,Stock according certainly.,-3900.1,Debit,35822.87,,system,2025-06-08 17:17:13.573057,system,2025-06-08 17:17:13.573057
7897fe416e124328819f484cf1295eca,6cfd605734e64c0cbfe3cfdb6f1a1afd,2025-05-30,Degree shoulder ok after face.,489.15,Credit,36312.02,,system,2025-06-08 17:17:13.573057,system,2025-06-08 17:17:13.573057
e50336ab55da421784f871623c77e401,6cfd605734e64c0cbfe3cfdb6f1a1afd,2025-01-04,Charge happen fight him those range less list.,-4087.9,Debit,32224.12,,system,2025-06-08 17:17:13.573057,system,2025-06-08 17:17:13.573057
1b0eb725ccfb4353aca5044ca12bedae,6d65f2534c7c463ea341ec1e75f2bb42,2025-02-10,Side power low good like herself cold.,-4627.98,Debit,45372.02,,system,2025-06-08 17:17:13.573057,system,2025-06-08 17:17:13.573057
1ae2457be2bb4dbeaedfd3a7d8d4f9cf,6d65f2534c7c463ea341ec1e75f2bb42,2024-12-22,Move partner least suggest dinner anyone present.,2903.1,Credit,48275.12,,system,2025-06-08 17:17:13.573057,system,2025-06-08 17:17:13.573057
f33b9541c6a44feb939e42cb33117825,6d65f2534c7c463ea341ec1e75f2bb42,2025-01-04,Identify minute book always suggest answer arrive.,-3972.93,Debit,44302.19,,system,2025-06-08 17:17:13.573057,system,2025-06-08 17:17:13.573057
9c7205f983314a90ab386b004d2113f0,6d65f2534c7c463ea341ec1e75f2bb42,2025-01-16,While heart contain identify movie last.,271.15,Credit,44573.34,,system,2025-06-08 17:17:13.573057,system,2025-06-08 17:17:13.573057
d4d285b2709a435ea2b179c557b203e0,6d65f2534c7c463ea341ec1e75f2bb42,2025-04-17,Quality goal compare nor item response.,1458.38,Credit,46031.72,,system,2025-06-08 17:17:13.573057,system,2025-06-08 17:17:13.573057
b5cfda51c96a4fb6a175e2d82f19ca92,6d65f2534c7c463ea341ec1e75f2bb42,2025-05-13,Herself economy plant leader entire.,-162.67,Debit,45869.05,,system,2025-06-08 17:17:13.573057,system,2025-06-08 17:17:13.573057
0313c7ad4c3147e09c64c590765ad9bd,6d65f2534c7c463ea341ec1e75f2bb42,2025-05-12,Anyone big age anyone.,-640.69,Debit,45228.36,,system,2025-06-08 17:17:13.573057,system,2025-06-08 17:17:13.573057
edff92926a624f27b9710da1380ed875,6d65f2534c7c463ea341ec1e75f2bb42,2025-03-01,Camera course decide operation.,-1341.86,Debit,43886.5,,system,2025-06-08 17:17:13.573057,system,2025-06-08 17:17:13.573057
f3e9d718a1e74761b8331bac275361de,6d65f2534c7c463ea341ec1e75f2bb42,2025-01-27,Able action new.,-757.07,Debit,43129.43,,system,2025-06-08 17:17:13.573057,system,2025-06-08 17:17:13.573057
47f2a392cc6b49729fd6164abd3dc503,6d65f2534c7c463ea341ec1e75f2bb42,2025-05-11,Agency stage population mind red.,4777.66,Credit,47907.09,,system,2025-06-08 17:17:13.573057,system,2025-06-08 17:17:13.573057
8cb6c5919a7a4af09abad50f8eccc006,dfe315e415474d428e3ce48f91f677cb,2025-01-13,More occur main work thing international protect.,-4148.13,Debit,45851.87,,system,2025-06-08 17:17:13.573057,system,2025-06-08 17:17:13.573057
70dffeec22fb4cb38d53b559750b9abc,dfe315e415474d428e3ce48f91f677cb,2025-03-02,Traditional sound appear wife arm.,-299.77,Debit,45552.1,,system,2025-06-08 17:17:13.573057,system,2025-06-08 17:17:13.573057
38a1f5a20eb44f3b965695ee23e4d71b,dfe315e415474d428e3ce48f91f677cb,2025-01-11,Recognize poor light paper candidate.,-614.59,Debit,44937.51,,system,2025-06-08 17:17:13.573057,system,2025-06-08 17:17:13.573057
7634e487a11342c3a9c429a461b72e41,dfe315e415474d428e3ce48f91f677cb,2025-01-26,Design system current garden try mean box outside.,2358.43,Credit,47295.94,,system,2025-06-08 17:17:13.573057,system,2025-06-08 17:17:13.573057
c8698e6e730d4025928a17c9921400b2,dfe315e415474d428e3ce48f91f677cb,2025-04-19,Media ever firm start least.,-2980.35,Debit,44315.59,,system,2025-06-08 17:17:13.573057,system,2025-06-08 17:17:13.573057
53765c2327574e61b25d4a7933d86181,dfe315e415474d428e3ce48f91f677cb,2025-05-23,Air involve price third whose management.,-3401.69,Debit,40913.9,,system,2025-06-08 17:17:13.573057,system,2025-06-08 17:17:13.573057
5e9d8459c14a4fd891806a79136dae3d,dfe315e415474d428e3ce48f91f677cb,2025-05-29,Particularly talk assume knowledge usually.,-235.1,Debit,40678.8,,system,2025-06-08 17:17:13.573057,system,2025-06-08 17:17:13.573057
dc3d59930b744993b21d1f4d039188b1,dfe315e415474d428e3ce48f91f677cb,2025-06-01,Value south eye pull capital maintain particular order.,2194.17,Credit,42872.97,,system,2025-06-08 17:17:13.573057,system,2025-06-08 17:17:13.573057
3c074ec7f5934774895758f9e6968bfa,dfe315e415474d428e3ce48f91f677cb,2025-01-22,Stuff believe sound citizen receive and piece.,-1671.61,Debit,41201.36,,system,2025-06-08 17:17:13.573057,system,2025-06-08 17:17:13.573057
78df9f9029684129966d1db65a34fe26,dfe315e415474d428e3ce48f91f677cb,2025-04-21,Use ok weight bed social.,-2926.21,Debit,38275.15,,system,2025-06-08 17:17:13.573057,system,2025-06-08 17:17:13.573057
30d98b4dabb24722af7de718dd5f7157,721bbebe80f4411daa8e99833afbad98,2024-12-26,Economy lose bar audience throughout democratic social push.,-2444.17,Debit,47555.83,,system,2025-06-08 17:17:13.573057,system,2025-06-08 17:17:13.573057
a7d3eaeaedd044d985d6aa75ec4c3bc3,721bbebe80f4411daa8e99833afbad98,2025-01-09,Would beat piece will.,391.19,Credit,47947.02,,system,2025-06-08 17:17:13.573057,system,2025-06-08 17:17:13.573057
e1e916434dd040feb3e071c92de95caa,721bbebe80f4411daa8e99833afbad98,2025-03-17,Against process throughout listen speech.,-1522.22,Debit,46424.8,,system,2025-06-08 17:17:13.573057,system,2025-06-08 17:17:13.573057
fcadc47d250047229a79c6c1927de505,721bbebe80f4411daa8e99833afbad98,2025-05-01,Evidence dream near movie citizen.,-602.68,Debit,45822.12,,system,2025-06-08 17:17:13.573057,system,2025-06-08 17:17:13.573057
50b66bd30c834d0d9b6d6e73c9bfb76f,721bbebe80f4411daa8e99833afbad98,2025-04-06,Religious cultural old information.,454.32,Credit,46276.44,,system,2025-06-08 17:17:13.573057,system,2025-06-08 17:17:13.573057
e8800fd47ff14eb3b9566701662b4541,721bbebe80f4411daa8e99833afbad98,2025-04-08,Item rule public since situation sign.,-1352.54,Debit,44923.9,,system,2025-06-08 17:17:13.573057,system,2025-06-08 17:17:13.573057
4d91e7e5ae84403eb2df1a11d69e8db8,721bbebe80f4411daa8e99833afbad98,2025-01-11,Brother involve possible.,4873.89,Credit,49797.79,,system,2025-06-08 17:17:13.573057,system,2025-06-08 17:17:13.573057
51c024fc3b684ec2b4907aafc2e3e9b1,721bbebe80f4411daa8e99833afbad98,2025-01-29,Yeah budget mention sport.,1561.34,Credit,51359.13,,system,2025-06-08 17:17:13.573057,system,2025-06-08 17:17:13.573057
0311e8cc5c6a43c2a022286bc228f86b,721bbebe80f4411daa8e99833afbad98,2025-04-29,Those situation how run.,-3369.06,Debit,47990.07,,system,2025-06-08 17:17:13.573057,system,2025-06-08 17:17:13.573057
078837101e854da288e8b1cc62848824,721bbebe80f4411daa8e99833afbad98,2024-12-22,Serious dark step compare eat area religious.,-1121.04,Debit,46869.03,,system,2025-06-08 17:17:13.573057,system,2025-06-08 17:17:13.573057
b02c5aba0a364cd08a67229ac8657011,a7576d43d9a44c86aa91ec88eb68e1a2,2025-02-09,Hospital final heart arm heart.,-3579.74,Debit,46420.26,,system,2025-06-08 17:17:13.573057,system,2025-06-08 17:17:13.573057
1880d606d23a46deac26e55358d2f606,a7576d43d9a44c86aa91ec88eb68e1a2,2024-12-11,Vote husband boy spend their himself.,4054.22,Credit,50474.48,,system,2025-06-08 17:17:13.573057,system,2025-06-08 17:17:13.573057
6fe09b9b20a44ec2b59fc8b81be2356c,a7576d43d9a44c86aa91ec88eb68e1a2,2025-01-16,Upon be source response health political.,-180.22,Debit,50294.26,,system,2025-06-08 17:17:13.573057,system,2025-06-08 17:17:13.573057
585cb361de65400a8e7ef16e5bfc1c75,a7576d43d9a44c86aa91ec88eb68e1a2,2024-12-16,Coach where the environment simply little clear.,-4566.86,Debit,45727.4,,system,2025-06-08 17:17:13.573057,system,2025-06-08 17:17:13.573057
73a71938c8b8467299720048afa8590a,a7576d43d9a44c86aa91ec88eb68e1a2,2025-04-01,Here beyond fish much.,-1697.49,Debit,44029.91,,system,2025-06-08 17:17:13.573057,system,2025-06-08 17:17:13.573057
4739b99228f24f45b4d9db3aaa273d15,a7576d43d9a44c86aa91ec88eb68e1a2,2025-02-19,Product trial reason teach by behind affect.,4290.31,Credit,48320.22,,system,2025-06-08 17:17:13.573057,system,2025-06-08 17:17:13.573057
b24b6339a69142fa852b5151bb8163a2,a7576d43d9a44c86aa91ec88eb68e1a2,2025-01-05,Person maybe reduce successful brother clear coach.,480.53,Credit,48800.75,,system,2025-06-08 17:17:13.573057,system,2025-06-08 17:17:13.573057
d030af9aaf504944b69a2ff2aa98df2a,a7576d43d9a44c86aa91ec88eb68e1a2,2025-06-07,Single suffer evening money.,3690.07,Credit,52490.82,,system,2025-06-08 17:17:13.573057,system,2025-06-08 17:17:13.573057
c573b583256c44c293c97122eb16722d,a7576d43d9a44c86aa91ec88eb68e1a2,2025-04-18,Least able manage during story despite.,3147.87,Credit,55638.69,,system,2025-06-08 17:17:13.573057,system,2025-06-08 17:17:13.573057
c886d3b84633457ea780d973d2e4145a,a7576d43d9a44c86aa91ec88eb68e1a2,2025-01-28,Only day kitchen.,-4935.4,Debit,50703.29,,system,2025-06-08 17:17:13.573057,system,2025-06-08 17:17:13.573057
5acc7a11d5ae49d7abfe5e3e551888e8,1ec36f6c3f3b44b09332aa0b061f88d7,2025-04-29,Both accept hospital social ground land.,-1590.28,Debit,48409.72,,system,2025-06-08 17:17:13.573057,system,2025-06-08 17:17:13.573057
24aae28038664554bd589bd899177ad3,1ec36f6c3f3b44b09332aa0b061f88d7,2025-02-10,Option concern visit theory approach.,4009.5,Credit,52419.22,,system,2025-06-08 17:17:13.573057,system,2025-06-08 17:17:13.573057
3f0a693807f04d679cabeb7679d39174,1ec36f6c3f3b44b09332aa0b061f88d7,2025-03-02,Music operation customer meeting policy model.,-3212.3,Debit,49206.92,,system,2025-06-08 17:17:13.573057,system,2025-06-08 17:17:13.573057
4f385e20f0ca42a7888797c8b4548a7c,1ec36f6c3f3b44b09332aa0b061f88d7,2025-01-16,Law it nice yes produce personal be hour.,-700.02,Debit,48506.9,,system,2025-06-08 17:17:13.573057,system,2025-06-08 17:17:13.573057
6986d884a7a04508bfbb5b4703e620d8,1ec36f6c3f3b44b09332aa0b061f88d7,2025-04-13,Rest series as happen unit black.,3111.19,Credit,51618.09,,system,2025-06-08 17:17:13.573057,system,2025-06-08 17:17:13.573057
dcd9587a773c4cc9ae5ad5e4fa36d6ee,1ec36f6c3f3b44b09332aa0b061f88d7,2025-05-22,Theory writer talk sign until ball.,-2449.54,Debit,49168.55,,system,2025-06-08 17:17:13.573057,system,2025-06-08 17:17:13.573057
89923da818554265aabca638a6b4b8df,1ec36f6c3f3b44b09332aa0b061f88d7,2025-05-24,Man visit loss game surface know part building.,1379.71,Credit,50548.26,,system,2025-06-08 17:17:13.573057,system,2025-06-08 17:17:13.573057
ddc85a7019fa4fd3bbdc17c3c26fa8f0,1ec36f6c3f3b44b09332aa0b061f88d7,2025-05-07,Create available two other or.,-3353.93,Debit,47194.33,,system,2025-06-08 17:17:13.573057,system,2025-06-08 17:17:13.573057
c69834aff7c545d8955da26184ce697a,1ec36f6c3f3b44b09332aa0b061f88d7,2025-03-06,Door specific worry foreign.,3747.88,Credit,50942.21,,system,2025-06-08 17:17:13.573057,system,2025-06-08 17:17:13.573057
48b156ec01204d93bbdc8470b6633943,1ec36f6c3f3b44b09332aa0b061f88d7,2025-02-19,Opportunity song deep whether people stage.,4433.88,Credit,55376.09,,system,2025-06-08 17:17:13.573057,system,2025-06-08 17:17:13.573057
689897ea1bde4b4eb2fafd8e452aaab5,66250ef958fb4f34aabc329ab1efc8eb,2025-04-08,Maybe trouble outside thought where as.,-3935.05,Debit,46064.95,,system,2025-06-08 17:17:13.573057,system,2025-06-08 17:17:13.573057
4de38f408f3b402eb5e81e074def9b62,66250ef958fb4f34aabc329ab1efc8eb,2025-01-20,Seat soon news generation toward unit.,-4955.82,Debit,41109.13,,system,2025-06-08 17:17:13.573057,system,2025-06-08 17:17:13.573057
fb39f1ece5674a11a4db8112eeb40f33,66250ef958fb4f34aabc329ab1efc8eb,2025-04-21,Or read four American.,-328.84,Debit,40780.29,,system,2025-06-08 17:17:13.573057,system,2025-06-08 17:17:13.573057
fcb21e6fa8494725a7059b6afb300262,66250ef958fb4f34aabc329ab1efc8eb,2025-06-07,Option along least adult action arm put.,4413.77,Credit,45194.06,,system,2025-06-08 17:17:13.573057,system,2025-06-08 17:17:13.573057
2a4a2d5fdf3a404f88e2f60f27bbd29b,66250ef958fb4f34aabc329ab1efc8eb,2025-01-15,White hundred they seat.,351.71,Credit,45545.77,,system,2025-06-08 17:17:13.573057,system,2025-06-08 17:17:13.573057
5c18427c497040caa80e06d98405dbc4,66250ef958fb4f34aabc329ab1efc8eb,2025-05-07,Almost light see party glass.,4238.58,Credit,49784.35,,system,2025-06-08 17:17:13.573057,system,2025-06-08 17:17:13.573057
a123d1ecd37a486b817e052bbdc3124e,66250ef958fb4f34aabc329ab1efc8eb,2025-06-06,Doctor hard summer listen.,3860.01,Credit,53644.36,,system,2025-06-08 17:17:13.573057,system,2025-06-08 17:17:13.573057
c4559dbcf18b4713ab4770d1463c769d,66250ef958fb4f34aabc329ab1efc8eb,2025-04-12,Again perform receive those business when place.,1389.09,Credit,55033.45,,system,2025-06-08 17:17:13.573057,system,2025-06-08 17:17:13.573057
745c4feff666473a8cfa44aad15e6c91,66250ef958fb4f34aabc329ab1efc8eb,2025-04-27,Officer anyone key indicate.,555.7,Credit,55589.15,,system,2025-06-08 17:17:13.573057,system,2025-06-08 17:17:13.573057
d4f145828c5e4b968055b0f5d00585f1,66250ef958fb4f34aabc329ab1efc8eb,2025-02-07,Close enter physical Congress.,4501.31,Credit,60090.46,,system,2025-06-08 17:17:13.573057,system,2025-06-08 17:17:13.573057
b7e25c60c1644dff92f11683489bbd71,a23c218a96494970bb46953d109a3f69,2025-05-10,Heavy thank see spend themselves eye indeed.,-308.57,Debit,49691.43,,system,2025-06-08 17:17:13.573057,system,2025-06-08 17:17:13.573057
80aff6c7754747369a9942972147f9e2,a23c218a96494970bb46953d109a3f69,2025-01-31,Nor box simple matter.,-3791.29,Debit,45900.14,,system,2025-06-08 17:17:13.573057,system,2025-06-08 17:17:13.573057
35b344cbeecd4135b400ea8fca97e4e1,a23c218a96494970bb46953d109a3f69,2025-03-19,Today near magazine final position lose major.,-2075.11,Debit,43825.03,,system,2025-06-08 17:17:13.573057,system,2025-06-08 17:17:13.573057
b83323800c31491ebbcdc2f746927309,a23c218a96494970bb46953d109a3f69,2025-02-05,Management Congress also feeling everybody history successful forget.,-3717.28,Debit,40107.75,,system,2025-06-08 17:17:13.573057,system,2025-06-08 17:17:13.573057
6a23d8987fc1493985e7cca8d3182291,a23c218a96494970bb46953d109a3f69,2025-03-01,Sound human go age cultural indicate local.,1524.73,Credit,41632.48,,system,2025-06-08 17:17:13.573057,system,2025-06-08 17:17:13.573057
3e917115f8934d36891817738a61a8d4,a23c218a96494970bb46953d109a3f69,2025-01-05,Owner identify much.,-3015.8,Debit,38616.68,,system,2025-06-08 17:17:13.573057,system,2025-06-08 17:17:13.573057
023fe38c03c94181983432e2682ed5c3,a23c218a96494970bb46953d109a3f69,2025-02-15,Reason usually institution throw.,-4385.21,Debit,34231.47,,system,2025-06-08 17:17:13.573057,system,2025-06-08 17:17:13.573057
9638059c96a949bf9460ee93bdba0e80,a23c218a96494970bb46953d109a3f69,2025-05-02,Myself under clearly treat man.,4074.0,Credit,38305.47,,system,2025-06-08 17:17:13.573057,system,2025-06-08 17:17:13.573057
09f224ae489240a5a4b07aaf47589059,a23c218a96494970bb46953d109a3f69,2025-05-03,Art property beyond where.,-4268.17,Debit,34037.3,,system,2025-06-08 17:17:13.573057,system,2025-06-08 17:17:13.573057
ca1df7fcb4bd49e1acde3e21a69bb089,a23c218a96494970bb46953d109a3f69,2025-03-29,Company son provide president attorney.,2163.28,Credit,36200.58,,system,2025-06-08 17:17:13.573057,system,2025-06-08 17:17:13.573057
0deb99022f4f4f3ebaef2937937af38c,adf03f9d780d42f69b74343dce817ec5,2025-03-25,Add special office standard.,-3591.88,Debit,46408.12,,system,2025-06-08 17:17:13.573057,system,2025-06-08 17:17:13.573057
e0096b85eb9f4d80926d9595cda26467,adf03f9d780d42f69b74343dce817ec5,2025-02-03,Direction perform play effort.,1751.36,Credit,48159.48,,system,2025-06-08 17:17:13.573057,system,2025-06-08 17:17:13.573057
f269d8f7eba940b5b4aa0ceb168809a0,adf03f9d780d42f69b74343dce817ec5,2024-12-17,Give price baby big exist.,-2833.94,Debit,45325.54,,system,2025-06-08 17:17:13.573057,system,2025-06-08 17:17:13.573057
ad1a6d12eb2442109d3373e49715406c,adf03f9d780d42f69b74343dce817ec5,2025-03-11,Read suffer give where community capital sport.,4643.12,Credit,49968.66,,system,2025-06-08 17:17:13.573057,system,2025-06-08 17:17:13.573057
9a4eae04c13f4c059fa5316c62608d11,adf03f9d780d42f69b74343dce817ec5,2025-02-05,Successful across front matter box spring institution.,2388.59,Credit,52357.25,,system,2025-06-08 17:17:13.573057,system,2025-06-08 17:17:13.573057
d6b39e52a600439a82b835f04008aea3,adf03f9d780d42f69b74343dce817ec5,2024-12-13,Even play different look.,3487.66,Credit,55844.91,,system,2025-06-08 17:17:13.573057,system,2025-06-08 17:17:13.573057
22acaef7e8bf4dc4bf5cd795f2b995ec,adf03f9d780d42f69b74343dce817ec5,2025-02-08,Short toward capital.,1622.15,Credit,57467.06,,system,2025-06-08 17:17:13.573057,system,2025-06-08 17:17:13.573057
e37bedfe2b6e4dac9c774dea3fae6d83,adf03f9d780d42f69b74343dce817ec5,2025-01-01,Great couple Congress end born.,-4060.64,Debit,53406.42,,system,2025-06-08 17:17:13.573057,system,2025-06-08 17:17:13.573057
e332aab26d9140139a219afbd6324bd2,adf03f9d780d42f69b74343dce817ec5,2025-02-19,Wonder attorney and management.,3342.19,Credit,56748.61,,system,2025-06-08 17:17:13.573057,system,2025-06-08 17:17:13.573057
1c284a996ade4e3c8c8dfa176d993a0b,adf03f9d780d42f69b74343dce817ec5,2024-12-17,Cultural doctor south yard federal discuss ever.,4346.76,Credit,61095.37,,system,2025-06-08 17:17:13.573057,system,2025-06-08 17:17:13.573057
059bde56400b4246ae26c107fdd1dda3,8b187b1b850a4b3e9c2f071ce792222b,2024-12-29,Move look herself heavy dinner.,796.24,Credit,50796.24,,system,2025-06-08 17:17:13.573057,system,2025-06-08 17:17:13.573057
7f7137dae8ee454c834bdb53d2621547,8b187b1b850a4b3e9c2f071ce792222b,2025-03-04,Position by must share particularly record laugh.,-252.63,Debit,50543.61,,system,2025-06-08 17:17:13.573057,system,2025-06-08 17:17:13.573057
94972ac0415b4996a1fe9cb2c2bf255f,8b187b1b850a4b3e9c2f071ce792222b,2025-01-03,Beat answer share test Democrat federal.,-1352.35,Debit,49191.26,,system,2025-06-08 17:17:13.573057,system,2025-06-08 17:17:13.573057
35dc34622ac247b4ac52bc414150b0f0,8b187b1b850a4b3e9c2f071ce792222b,2025-02-26,Dinner test trade value perhaps suffer.,-654.98,Debit,48536.28,,system,2025-06-08 17:17:13.573057,system,2025-06-08 17:17:13.573057
d2f066c5ce7141b391321a96f2310628,8b187b1b850a4b3e9c2f071ce792222b,2025-02-12,Give possible range none important situation.,-973.64,Debit,47562.64,,system,2025-06-08 17:17:13.573057,system,2025-06-08 17:17:13.573057
cdf6b6910faa4e58b4258b02c4c73e07,8b187b1b850a4b3e9c2f071ce792222b,2025-05-29,Loss maintain travel clearly usually.,-932.8,Debit,46629.84,,system,2025-06-08 17:17:13.573057,system,2025-06-08 17:17:13.573057
c8ce3ed2db854019a2ba65fbb0e4fdeb,8b187b1b850a4b3e9c2f071ce792222b,2024-12-16,Doctor card continue.,1072.56,Credit,47702.4,,system,2025-06-08 17:17:13.573057,system,2025-06-08 17:17:13.573057
3c3241d4ca09445aa151133986a2a218,8b187b1b850a4b3e9c2f071ce792222b,2025-04-09,Name best land.,-1223.72,Debit,46478.68,,system,2025-06-08 17:17:13.573057,system,2025-06-08 17:17:13.573057
2c913ed8c47a4ed0bcd2b643481ef7ea,8b187b1b850a4b3e9c2f071ce792222b,2025-04-01,Country box risk threat stuff.,-3052.29,Debit,43426.39,,system,2025-06-08 17:17:13.573057,system,2025-06-08 17:17:13.573057
52b74fbda1a74505a70841f9ab4dcc20,8b187b1b850a4b3e9c2f071ce792222b,2025-01-02,Maybe ahead lead present spend.,-4839.22,Debit,38587.17,,system,2025-06-08 17:17:13.573057,system,2025-06-08 17:17:13.573057
3d4f7200575b4668aa59ee15d2c7d924,6ad9054d4e5440a29ed7adf42b40ff67,2025-05-01,Them choice author finish.,2134.0,Credit,52134.0,,system,2025-06-08 17:17:13.573057,system,2025-06-08 17:17:13.573057
def115c47b74421f941266e58082c6d0,6ad9054d4e5440a29ed7adf42b40ff67,2025-03-28,Bed treat record form painting.,-3385.23,Debit,48748.77,,system,2025-06-08 17:17:13.573057,system,2025-06-08 17:17:13.573057
bba4cf36941b45fbb8e83f58c737e131,6ad9054d4e5440a29ed7adf42b40ff67,2024-12-18,Marriage indicate join doctor go nation.,4449.76,Credit,53198.53,,system,2025-06-08 17:17:13.573057,system,2025-06-08 17:17:13.573057
178c2eec04104354b09332768e756e7d,6ad9054d4e5440a29ed7adf42b40ff67,2025-03-07,Each result measure mention.,-1201.38,Debit,51997.15,,system,2025-06-08 17:17:13.573057,system,2025-06-08 17:17:13.573057
840bd29190ea48549797ed9f8801eb47,6ad9054d4e5440a29ed7adf42b40ff67,2025-02-11,Ability production opportunity thought how institution simple.,-3037.23,Debit,48959.92,,system,2025-06-08 17:17:13.573057,system,2025-06-08 17:17:13.573057
31267ec548074f488bb6aadff67b441b,6ad9054d4e5440a29ed7adf42b40ff67,2024-12-13,Particular both both decide lead.,1241.43,Credit,50201.35,,system,2025-06-08 17:17:13.573057,system,2025-06-08 17:17:13.573057
a3158a3d438241238b0f7d6ef84f20cd,6ad9054d4e5440a29ed7adf42b40ff67,2025-05-17,Plant professor event to from.,-3177.01,Debit,47024.34,,system,2025-06-08 17:17:13.573057,system,2025-06-08 17:17:13.573057
8c6433869ead42ecb42b566f356f2274,6ad9054d4e5440a29ed7adf42b40ff67,2025-04-03,Later kid recent enough during sea increase.,794.55,Credit,47818.89,,system,2025-06-08 17:17:13.573057,system,2025-06-08 17:17:13.573057
ee3c406836914ab19fe88508e37967dd,6ad9054d4e5440a29ed7adf42b40ff67,2024-12-31,Different own agree sing end.,-2561.23,Debit,45257.66,,system,2025-06-08 17:17:13.573057,system,2025-06-08 17:17:13.573057
fd1aba548f6f45d79338a683f7105ce7,6ad9054d4e5440a29ed7adf42b40ff67,2025-02-11,My business face my baby.,2034.2,Credit,47291.86,,system,2025-06-08 17:17:13.573057,system,2025-06-08 17:17:13.573057
b17de2971e834da78d55c15a782d5fa3,b56dc8f03215436eb7e06809159637d9,2024-12-13,Music method space pick meet we myself.,-4787.49,Debit,45212.51,,system,2025-06-08 17:17:13.573057,system,2025-06-08 17:17:13.573057
dfb0bee24062404ea2044f075c939d6b,b56dc8f03215436eb7e06809159637d9,2024-12-19,Newspaper green create color.,-2154.86,Debit,43057.65,,system,2025-06-08 17:17:13.573057,system,2025-06-08 17:17:13.573057
986797ca5c6845bb8fd2da3a1d652ea1,b56dc8f03215436eb7e06809159637d9,2025-05-27,Each foot firm oil.,-2567.53,Debit,40490.12,,system,2025-06-08 17:17:13.573057,system,2025-06-08 17:17:13.573057
f2d9db5264df4850b44190ff36f1dfef,b56dc8f03215436eb7e06809159637d9,2025-03-15,Us cause want paper begin factor staff safe.,2622.63,Credit,43112.75,,system,2025-06-08 17:17:13.573057,system,2025-06-08 17:17:13.573057
8908371a80b5451c8c1418dd3ba06e88,b56dc8f03215436eb7e06809159637d9,2024-12-27,Card art population his century two.,-71.58,Debit,43041.17,,system,2025-06-08 17:17:13.573057,system,2025-06-08 17:17:13.573057
8f3a9e68eb984e22ab873412b8ebb006,b56dc8f03215436eb7e06809159637d9,2025-05-18,Win specific story quite.,867.44,Credit,43908.61,,system,2025-06-08 17:17:13.573057,system,2025-06-08 17:17:13.573057
ce84b100221b4fed9792445a032d5f94,b56dc8f03215436eb7e06809159637d9,2025-03-16,Increase east change.,4078.73,Credit,47987.34,,system,2025-06-08 17:17:13.573057,system,2025-06-08 17:17:13.573057
f6a6ee44e0d8423c83fb8e1fea61491a,b56dc8f03215436eb7e06809159637d9,2024-12-11,Minute end what degree Mr.,-4628.58,Debit,43358.76,,system,2025-06-08 17:17:13.573057,system,2025-06-08 17:17:13.573057
1791fb8d20684269a1be63903cfd0aad,b56dc8f03215436eb7e06809159637d9,2025-05-22,While within while he say federal.,-4038.17,Debit,39320.59,,system,2025-06-08 17:17:13.573057,system,2025-06-08 17:17:13.573057
fcd3268f4c8e49b197843ad56e5396a4,b56dc8f03215436eb7e06809159637d9,2025-05-01,Position difficult keep rest.,-1030.35,Debit,38290.24,,system,2025-06-08 17:17:13.573057,system,2025-06-08 17:17:13.573057
fb1ce7c560054226be29d7cf49816c75,5beaace9e1464343bb45b9aa722c34c8,2025-06-01,Crime only child light agreement let.,-809.41,Debit,49190.59,,system,2025-06-08 17:17:13.573057,system,2025-06-08 17:17:13.573057
7002e3d135b643139063cbc00b8e7907,5beaace9e1464343bb45b9aa722c34c8,2025-05-05,Main still must yes billion former improve.,39.19,Credit,49229.78,,system,2025-06-08 17:17:13.573057,system,2025-06-08 17:17:13.573057
7f19a6478bbe48e2be7ca336dedaa2eb,5beaace9e1464343bb45b9aa722c34c8,2025-01-16,Politics method store likely as protect.,-986.74,Debit,48243.04,,system,2025-06-08 17:17:13.573057,system,2025-06-08 17:17:13.573057
49c0676524114dd5bb389407051a4360,5beaace9e1464343bb45b9aa722c34c8,2025-04-16,Stand want rate field always rather.,718.21,Credit,48961.25,,system,2025-06-08 17:17:13.573057,system,2025-06-08 17:17:13.573057
591c701acbfe4bc3958aa16a47e5f57c,5beaace9e1464343bb45b9aa722c34c8,2025-02-09,Court because wall stop ever rest chair.,1694.25,Credit,50655.5,,system,2025-06-08 17:17:13.573057,system,2025-06-08 17:17:13.573057
c078845046fd4e73b0597503aa5b1428,5beaace9e1464343bb45b9aa722c34c8,2025-01-06,Couple those half individual describe energy.,4097.35,Credit,54752.85,,system,2025-06-08 17:17:13.573057,system,2025-06-08 17:17:13.573057
3eda1d9492cb47a1bd5fa387d88cf152,5beaace9e1464343bb45b9aa722c34c8,2025-01-17,Energy interesting so degree support reduce ask.,-442.86,Debit,54309.99,,system,2025-06-08 17:17:13.573057,system,2025-06-08 17:17:13.573057
e03ffee07ed94f3aa03b0080a468d7ee,5beaace9e1464343bb45b9aa722c34c8,2025-04-17,Write scientist example hour.,4185.14,Credit,58495.13,,system,2025-06-08 17:17:13.573057,system,2025-06-08 17:17:13.573057
bbc3d964c34e4d9786164ff648ad0012,5beaace9e1464343bb45b9aa722c34c8,2025-03-27,Nature free even every place.,-2793.43,Debit,55701.7,,system,2025-06-08 17:17:13.573057,system,2025-06-08 17:17:13.573057
9e3d44a1cfe9450f84794b5752aad026,5beaace9e1464343bb45b9aa722c34c8,2025-04-17,Herself follow necessary newspaper several.,76.0,Credit,55777.7,,system,2025-06-08 17:17:13.573057,system,2025-06-08 17:17:13.573057
8e2ac36ff9554c059a4c61ba68d64977,804dc92f8b0f44c597695d3c687ccbd3,2025-05-17,Try phone name general always product.,-1418.43,Debit,48581.57,,system,2025-06-08 17:17:13.573057,system,2025-06-08 17:17:13.573057
f696311a1de1462a993d79c8f090cef8,804dc92f8b0f44c597695d3c687ccbd3,2025-05-12,Budget discover expert.,1001.23,Credit,49582.8,,system,2025-06-08 17:17:13.573057,system,2025-06-08 17:17:13.573057
d8a9a72d17a94d34822a841a08faf088,804dc92f8b0f44c597695d3c687ccbd3,2025-02-25,Create carry own rise very.,-2163.12,Debit,47419.68,,system,2025-06-08 17:17:13.573057,system,2025-06-08 17:17:13.573057
689c3337a35842c8b24ddd93139c001d,804dc92f8b0f44c597695d3c687ccbd3,2025-05-16,International recently service mission arrive give.,-280.06,Debit,47139.62,,system,2025-06-08 17:17:13.573057,system,2025-06-08 17:17:13.573057
4e835e97b37c4d55b53f63c3dbc24c0b,804dc92f8b0f44c597695d3c687ccbd3,2025-03-02,Girl beyond water.,3182.02,Credit,50321.64,,system,2025-06-08 17:17:13.573057,system,2025-06-08 17:17:13.573057
22caeeeddd7c475093ec4c0189b3c823,804dc92f8b0f44c597695d3c687ccbd3,2025-01-30,Able enjoy he discover daughter age.,-2575.34,Debit,47746.3,,system,2025-06-08 17:17:13.573057,system,2025-06-08 17:17:13.573057
67b1f17901fc4308a1ed0a3a620a38d0,804dc92f8b0f44c597695d3c687ccbd3,2024-12-28,Expect yet however size least artist.,4241.27,Credit,51987.57,,system,2025-06-08 17:17:13.573057,system,2025-06-08 17:17:13.573057
3aab8c8ef91344ad87e768f28925019a,804dc92f8b0f44c597695d3c687ccbd3,2025-03-28,Research fill may write federal issue.,-1126.61,Debit,50860.96,,system,2025-06-08 17:17:13.588571,system,2025-06-08 17:17:13.588571
f378aa32ee3c47a0956757077cae1b46,804dc92f8b0f44c597695d3c687ccbd3,2025-04-08,Five positive loss really yeah list.,1787.79,Credit,52648.75,,system,2025-06-08 17:17:13.588571,system,2025-06-08 17:17:13.588571
fa9f27fe09394ef3912dc305a218536d,804dc92f8b0f44c597695d3c687ccbd3,2025-06-03,College thousand story listen hand development family.,3123.13,Credit,55771.88,,system,2025-06-08 17:17:13.588571,system,2025-06-08 17:17:13.588571
f15f4f66070d47bea4da51d802377542,f603129501d24640a9af91f390289e7d,2025-05-16,Foot their deep else feel.,3765.96,Credit,53765.96,,system,2025-06-08 17:17:13.588571,system,2025-06-08 17:17:13.588571
25d9dcae230d4368ace754dae8c0a136,f603129501d24640a9af91f390289e7d,2025-02-02,Deep edge large impact.,4424.11,Credit,58190.07,,system,2025-06-08 17:17:13.588571,system,2025-06-08 17:17:13.588571
3ff20d30ef8545c4b7fe2448f2c10c65,f603129501d24640a9af91f390289e7d,2024-12-22,Protect item rest group project Congress.,1926.73,Credit,60116.8,,system,2025-06-08 17:17:13.588571,system,2025-06-08 17:17:13.588571
11de532af5ec427a9b8b6e070220b974,f603129501d24640a9af91f390289e7d,2025-03-07,Close southern appear.,-923.32,Debit,59193.48,,system,2025-06-08 17:17:13.588571,system,2025-06-08 17:17:13.588571
8ab204eb22b744ffaeaf360f97e078cd,f603129501d24640a9af91f390289e7d,2025-01-27,Offer explain last a.,-3537.47,Debit,55656.01,,system,2025-06-08 17:17:13.588571,system,2025-06-08 17:17:13.588571
389cfa1b945d4ed9a068a82979bc6535,f603129501d24640a9af91f390289e7d,2025-02-28,Glass building wish.,-3580.13,Debit,52075.88,,system,2025-06-08 17:17:13.588571,system,2025-06-08 17:17:13.588571
78e3c76741714acc9b352cf6e129b292,f603129501d24640a9af91f390289e7d,2025-04-02,Address yes view ball figure suggest hit everybody.,387.26,Credit,52463.14,,system,2025-06-08 17:17:13.588571,system,2025-06-08 17:17:13.588571
6191da0331fd4f0c86d445de4f68a51f,f603129501d24640a9af91f390289e7d,2025-01-08,Able star face speak laugh method which.,3583.11,Credit,56046.25,,system,2025-06-08 17:17:13.588571,system,2025-06-08 17:17:13.588571
a9643c33869d4639b1df8c182bbbabbf,f603129501d24640a9af91f390289e7d,2025-02-01,Particular mouth hold table high course common network.,4016.42,Credit,60062.67,,system,2025-06-08 17:17:13.588571,system,2025-06-08 17:17:13.588571
f1ef52ef317148c0b3ed6a74b7495cbb,f603129501d24640a9af91f390289e7d,2025-03-26,Cost cup order player evening wear.,1698.11,Credit,61760.78,,system,2025-06-08 17:17:13.588571,system,2025-06-08 17:17:13.588571
e39f85fb68364b66942e2e0bf85aa99d,82e8790420f641e6992549279cc4fe4c,2025-05-31,Vote by maybe most why.,-4973.86,Debit,45026.14,,system,2025-06-08 17:17:13.588571,system,2025-06-08 17:17:13.588571
f70c6681f99c454684d16596b55a2e1f,82e8790420f641e6992549279cc4fe4c,2024-12-18,Weight matter magazine never.,1892.06,Credit,46918.2,,system,2025-06-08 17:17:13.588571,system,2025-06-08 17:17:13.588571
c1cd2b3e349c42bd928f43017bfb44fd,82e8790420f641e6992549279cc4fe4c,2025-06-03,Expert great support goal box minute.,1578.29,Credit,48496.49,,system,2025-06-08 17:17:13.588571,system,2025-06-08 17:17:13.588571
7e99442729c94d79a3ee2bb95d2433f5,82e8790420f641e6992549279cc4fe4c,2024-12-20,Sound probably no speak his.,461.04,Credit,48957.53,,system,2025-06-08 17:17:13.588571,system,2025-06-08 17:17:13.588571
ee86c307f2bf43aa9acc0efb8daf051d,82e8790420f641e6992549279cc4fe4c,2025-03-23,Crime seek receive.,-4503.71,Debit,44453.82,,system,2025-06-08 17:17:13.588571,system,2025-06-08 17:17:13.588571
5f0a6416daa74786bd28c64c3fba8095,82e8790420f641e6992549279cc4fe4c,2025-03-04,Learn table today score need of.,1665.4,Credit,46119.22,,system,2025-06-08 17:17:13.588571,system,2025-06-08 17:17:13.588571
791547f095174b66a8f31d2f74122e1e,82e8790420f641e6992549279cc4fe4c,2025-03-19,Effort air enough seek management today environmental.,2899.11,Credit,49018.33,,system,2025-06-08 17:17:13.588571,system,2025-06-08 17:17:13.588571
03b3017abfe948d2a974dd06926a444e,82e8790420f641e6992549279cc4fe4c,2025-06-02,Set guy community soldier company.,-4139.84,Debit,44878.49,,system,2025-06-08 17:17:13.588571,system,2025-06-08 17:17:13.588571
d3f5501adb43470daea6087cb252ba30,82e8790420f641e6992549279cc4fe4c,2025-03-14,Chance against run mind trade increase raise.,594.78,Credit,45473.27,,system,2025-06-08 17:17:13.588571,system,2025-06-08 17:17:13.588571
6e739cdefc0e4e70a36c27d313d9d388,82e8790420f641e6992549279cc4fe4c,2025-05-03,White be eye from great amount movie.,-2201.97,Debit,43271.3,,system,2025-06-08 17:17:13.588571,system,2025-06-08 17:17:13.588571
67730adb7e994461a4bfd4019022192a,838ba59cecfb4e09b008a0a7473a32f2,2025-05-10,Outside tend some research role such mind.,-44.93,Debit,49955.07,,system,2025-06-08 17:17:13.588571,system,2025-06-08 17:17:13.588571
1fa3bb85dd394c2c9c94d4d7f49fcf87,838ba59cecfb4e09b008a0a7473a32f2,2024-12-24,Team success rule chance who.,-993.56,Debit,48961.51,,system,2025-06-08 17:17:13.588571,system,2025-06-08 17:17:13.588571
b35510435f3f4d29a0c988afc70fd84f,838ba59cecfb4e09b008a0a7473a32f2,2025-05-25,Avoid simple allow cup arm someone.,-2970.82,Debit,45990.69,,system,2025-06-08 17:17:13.588571,system,2025-06-08 17:17:13.588571
dbc1456969de404f8590148f4823c46e,838ba59cecfb4e09b008a0a7473a32f2,2024-12-12,South hour sport bit laugh.,3791.08,Credit,49781.77,,system,2025-06-08 17:17:13.588571,system,2025-06-08 17:17:13.588571
5e626c9e446847008487e405f8d51ae1,838ba59cecfb4e09b008a0a7473a32f2,2025-04-09,Back law notice hundred him work culture.,2254.91,Credit,52036.68,,system,2025-06-08 17:17:13.588571,system,2025-06-08 17:17:13.588571
01edbff29f224d9d9b7351617052b043,838ba59cecfb4e09b008a0a7473a32f2,2025-02-21,Action never able five month beautiful course main.,-1797.32,Debit,50239.36,,system,2025-06-08 17:17:13.588571,system,2025-06-08 17:17:13.588571
38d8566adb9d480d9dc86c4f46ec6c40,838ba59cecfb4e09b008a0a7473a32f2,2025-04-14,Ago page take customer exactly report people.,3450.16,Credit,53689.52,,system,2025-06-08 17:17:13.588571,system,2025-06-08 17:17:13.588571
af384584a33d41e98e4ab6b352604117,838ba59cecfb4e09b008a0a7473a32f2,2025-04-18,Leader his it institution cut some.,-1186.11,Debit,52503.41,,system,2025-06-08 17:17:13.588571,system,2025-06-08 17:17:13.588571
c98b426c8c9f46509fe461c9738d5837,838ba59cecfb4e09b008a0a7473a32f2,2025-05-17,Set result policy bring who laugh effort.,3118.24,Credit,55621.65,,system,2025-06-08 17:17:13.588571,system,2025-06-08 17:17:13.588571
7e7d72dfc3454818bdc938d3e3b7c266,838ba59cecfb4e09b008a0a7473a32f2,2025-05-25,Money increase quite art moment.,4070.75,Credit,59692.4,,system,2025-06-08 17:17:13.588571,system,2025-06-08 17:17:13.588571
0997d91dbbf94a80b62b4dc03f62a3fe,9f376e5a6e4c45bc9a7c9c49905a2bd3,2025-01-09,Number move land take camera environmental he will.,2223.82,Credit,52223.82,,system,2025-06-08 17:17:13.588571,system,2025-06-08 17:17:13.588571
a9514c70530147e5b386519f5d617926,9f376e5a6e4c45bc9a7c9c49905a2bd3,2025-01-07,Respond piece worker off mention hear science.,-4475.85,Debit,47747.97,,system,2025-06-08 17:17:13.588571,system,2025-06-08 17:17:13.588571
d409c38ca3ff4b94beb08d8916483550,9f376e5a6e4c45bc9a7c9c49905a2bd3,2025-05-23,Throughout wish situation weight medical late her.,886.44,Credit,48634.41,,system,2025-06-08 17:17:13.588571,system,2025-06-08 17:17:13.588571
8e60a9fbad2c4b86b219764f501ee002,9f376e5a6e4c45bc9a7c9c49905a2bd3,2025-01-26,Consumer worker draw none.,530.44,Credit,49164.85,,system,2025-06-08 17:17:13.588571,system,2025-06-08 17:17:13.588571
1d2d0e5ff9344353a3e412419da1b609,9f376e5a6e4c45bc9a7c9c49905a2bd3,2025-06-08,Simply least himself off staff figure peace.,-3860.42,Debit,45304.43,,system,2025-06-08 17:17:13.588571,system,2025-06-08 17:17:13.588571
e5ccbc74d6914b819ce83353b96b1c4f,9f376e5a6e4c45bc9a7c9c49905a2bd3,2025-03-21,Friend on plant party everyone region.,3095.42,Credit,48399.85,,system,2025-06-08 17:17:13.588571,system,2025-06-08 17:17:13.588571
39965cd49e694b71ac75555b862d5155,9f376e5a6e4c45bc9a7c9c49905a2bd3,2025-01-23,Rest artist camera foreign vote break picture.,3536.08,Credit,51935.93,,system,2025-06-08 17:17:13.588571,system,2025-06-08 17:17:13.588571
7e6017419e3b4572b3e12248069f8499,9f376e5a6e4c45bc9a7c9c49905a2bd3,2025-04-25,Hold someone begin to born enjoy hotel.,4671.77,Credit,56607.7,,system,2025-06-08 17:17:13.588571,system,2025-06-08 17:17:13.588571
aa8aec67254842db9002f7ebd6bc2e0f,9f376e5a6e4c45bc9a7c9c49905a2bd3,2025-04-10,Action development plant crime room consider ability.,267.27,Credit,56874.97,,system,2025-06-08 17:17:13.588571,system,2025-06-08 17:17:13.588571
62c9b6958c3d490a8bc7d5f8336d392e,9f376e5a6e4c45bc9a7c9c49905a2bd3,2025-03-29,Particular black particular home rise prove civil fire.,-1640.78,Debit,55234.19,,system,2025-06-08 17:17:13.588571,system,2025-06-08 17:17:13.588571
090bbb74bd7f48abae56b00c56d49d83,289aba75febb4c8cba61fffdf1aa6f8f,2025-01-20,Act plan season board.,-4355.31,Debit,45644.69,,system,2025-06-08 17:17:13.588571,system,2025-06-08 17:17:13.588571
eaa911dfca3b46f6abc6022b855ffc3a,289aba75febb4c8cba61fffdf1aa6f8f,2025-01-06,Fast case happy.,3807.81,Credit,49452.5,,system,2025-06-08 17:17:13.588571,system,2025-06-08 17:17:13.588571
d31faee291fb4b62a6cd55db6abdb794,289aba75febb4c8cba61fffdf1aa6f8f,2024-12-31,Power direction statement focus.,2559.98,Credit,52012.48,,system,2025-06-08 17:17:13.588571,system,2025-06-08 17:17:13.588571
6bd662b6be644097903fb08b0ebb90ae,289aba75febb4c8cba61fffdf1aa6f8f,2024-12-31,Make environmental bill heart.,1829.43,Credit,53841.91,,system,2025-06-08 17:17:13.588571,system,2025-06-08 17:17:13.588571
2614ae438efc4c1dbe8cc405830d1c52,289aba75febb4c8cba61fffdf1aa6f8f,2025-05-27,Sound believe me watch carry oil.,2395.95,Credit,56237.86,,system,2025-06-08 17:17:13.588571,system,2025-06-08 17:17:13.588571
f31d98f826274d84b5416471c619809d,289aba75febb4c8cba61fffdf1aa6f8f,2024-12-10,Inside near population choose memory true game.,4234.62,Credit,60472.48,,system,2025-06-08 17:17:13.588571,system,2025-06-08 17:17:13.588571
01308e563cd64017a2bcf55a5a2f85d2,289aba75febb4c8cba61fffdf1aa6f8f,2025-02-15,Final goal benefit yard really class little.,-2793.75,Debit,57678.73,,system,2025-06-08 17:17:13.588571,system,2025-06-08 17:17:13.588571
212a43589b4f48fcb8b3d0232f89a476,289aba75febb4c8cba61fffdf1aa6f8f,2025-05-17,Wide great country.,-828.41,Debit,56850.32,,system,2025-06-08 17:17:13.588571,system,2025-06-08 17:17:13.588571
fbc2f743ef234b79b7ce7b2763f47641,289aba75febb4c8cba61fffdf1aa6f8f,2025-02-22,Necessary box authority public quality television.,-2575.58,Debit,54274.74,,system,2025-06-08 17:17:13.588571,system,2025-06-08 17:17:13.588571
511feb49c2a047d092fd5b6d1d8b3b95,289aba75febb4c8cba61fffdf1aa6f8f,2025-01-23,May because compare partner cold middle hundred.,-1060.92,Debit,53213.82,,system,2025-06-08 17:17:13.588571,system,2025-06-08 17:17:13.588571
3dab7747ce0d497db1e4765dbf961e25,5c104f5f2b5740a4aa5dbb5e7660c4b5,2025-06-02,Memory company door must report newspaper.,4161.9,Credit,54161.9,,system,2025-06-08 17:17:13.588571,system,2025-06-08 17:17:13.588571
b39c8d9a2eca4fd2b145663e86fdcde1,5c104f5f2b5740a4aa5dbb5e7660c4b5,2025-05-18,Chance watch return measure speech might.,118.45,Credit,54280.35,,system,2025-06-08 17:17:13.588571,system,2025-06-08 17:17:13.588571
991adb228c1d41f3904de574a44c77c0,5c104f5f2b5740a4aa5dbb5e7660c4b5,2025-05-04,Size cell money billion of tax against.,-3596.69,Debit,50683.66,,system,2025-06-08 17:17:13.588571,system,2025-06-08 17:17:13.588571
90702658e78444d6914656a88e1c988a,5c104f5f2b5740a4aa5dbb5e7660c4b5,2025-02-19,Learn leg behavior oil we pressure strong.,1743.79,Credit,52427.45,,system,2025-06-08 17:17:13.588571,system,2025-06-08 17:17:13.588571
54f87b4011884f59a5e2d68fe9bf9e23,5c104f5f2b5740a4aa5dbb5e7660c4b5,2025-03-11,Of record simple.,199.13,Credit,52626.58,,system,2025-06-08 17:17:13.588571,system,2025-06-08 17:17:13.588571
9a1b5e2938e24edaa73b9bbad136378e,5c104f5f2b5740a4aa5dbb5e7660c4b5,2025-01-13,Million modern throughout crime three.,3530.5,Credit,56157.08,,system,2025-06-08 17:17:13.588571,system,2025-06-08 17:17:13.588571
b2f662dc76e9475eb20de5f2d475d0db,5c104f5f2b5740a4aa5dbb5e7660c4b5,2025-02-11,Do account get natural state thought.,-1969.0,Debit,54188.08,,system,2025-06-08 17:17:13.588571,system,2025-06-08 17:17:13.588571
c886e51fea414c2f80e1d907ff1e1583,5c104f5f2b5740a4aa5dbb5e7660c4b5,2025-04-04,Look practice far just.,3941.29,Credit,58129.37,,system,2025-06-08 17:17:13.588571,system,2025-06-08 17:17:13.588571
6ddef2639f0240b483457d9ecb013771,5c104f5f2b5740a4aa5dbb5e7660c4b5,2025-06-08,Team Congress which strategy office read decide charge.,2691.04,Credit,60820.41,,system,2025-06-08 17:17:13.588571,system,2025-06-08 17:17:13.588571
05b38a8c1c8e4a51948a48663fb4255f,5c104f5f2b5740a4aa5dbb5e7660c4b5,2025-04-13,Simply look onto clearly per power.,3718.15,Credit,64538.56,,system,2025-06-08 17:17:13.588571,system,2025-06-08 17:17:13.588571
f71469e354fc42809daa274c48f87d7d,08b69aff3d964dabba5997c845997495,2025-05-17,Success anyone letter position tell.,-4263.5,Debit,45736.5,,system,2025-06-08 17:17:13.588571,system,2025-06-08 17:17:13.588571
987dd248d738451f9feb1a0650653cf7,08b69aff3d964dabba5997c845997495,2025-03-11,What camera there example.,-4636.64,Debit,41099.86,,system,2025-06-08 17:17:13.588571,system,2025-06-08 17:17:13.588571
73e7b865375f408488124fc0b5cbe2c4,08b69aff3d964dabba5997c845997495,2025-04-15,Not heart create herself physical easy.,1808.81,Credit,42908.67,,system,2025-06-08 17:17:13.588571,system,2025-06-08 17:17:13.588571
5937996983264281b1f6b0fb18da42d1,08b69aff3d964dabba5997c845997495,2025-04-07,Away prepare information memory.,1743.43,Credit,44652.1,,system,2025-06-08 17:17:13.588571,system,2025-06-08 17:17:13.588571
47f0653b9b7e407b8d51f042f7868db9,08b69aff3d964dabba5997c845997495,2025-01-03,Summer talk huge project public minute ago.,-4916.33,Debit,39735.77,,system,2025-06-08 17:17:13.588571,system,2025-06-08 17:17:13.588571
4e588e51713d4e2daee40a440bb59fa9,08b69aff3d964dabba5997c845997495,2025-04-18,Create quickly either clear.,-673.5,Debit,39062.27,,system,2025-06-08 17:17:13.588571,system,2025-06-08 17:17:13.588571
6fc553f6a7d54839992c7dff0d234e17,08b69aff3d964dabba5997c845997495,2025-01-01,Such others build land dinner raise.,1046.6,Credit,40108.87,,system,2025-06-08 17:17:13.594087,system,2025-06-08 17:17:13.594087
d38792ce19f84eb3880890a0815b6dd5,08b69aff3d964dabba5997c845997495,2025-05-04,Trouble option talk sign.,38.38,Credit,40147.25,,system,2025-06-08 17:17:13.594087,system,2025-06-08 17:17:13.594087
53d36469141f4a1584a6f972652e55dd,08b69aff3d964dabba5997c845997495,2025-01-10,Myself suggest discussion school hold.,-4053.36,Debit,36093.89,,system,2025-06-08 17:17:13.594087,system,2025-06-08 17:17:13.594087
24e7158ee6904f5e94ca59dc8485a0a2,08b69aff3d964dabba5997c845997495,2025-03-22,Issue believe reason firm decide.,4874.35,Credit,40968.24,,system,2025-06-08 17:17:13.594087,system,2025-06-08 17:17:13.594087
24854e8fdb304aea81a59ccc0a1e0f71,6a95eeecbcaf44e49ed2dd23179fa64e,2025-02-20,Model in democratic so product have.,-3600.69,Debit,46399.31,,system,2025-06-08 17:17:13.594087,system,2025-06-08 17:17:13.594087
89a0e616566d4d2d82c21fa6eaecf3da,6a95eeecbcaf44e49ed2dd23179fa64e,2025-02-07,Finish science record final cut red amount.,1064.04,Credit,47463.35,,system,2025-06-08 17:17:13.594087,system,2025-06-08 17:17:13.594087
66976a30a38d49cbbc9600ddbfb5520c,6a95eeecbcaf44e49ed2dd23179fa64e,2025-03-09,Prevent sure cover enter main war investment.,4986.98,Credit,52450.33,,system,2025-06-08 17:17:13.594087,system,2025-06-08 17:17:13.594087
661af35c0d0142cf9ab97bc1713747f9,6a95eeecbcaf44e49ed2dd23179fa64e,2025-05-13,Serious sister artist scientist create.,1476.39,Credit,53926.72,,system,2025-06-08 17:17:13.594087,system,2025-06-08 17:17:13.594087
ec81fa6a4ca44c83ba1caba1bf184c18,6a95eeecbcaf44e49ed2dd23179fa64e,2025-02-04,Develop hear together page as.,-944.64,Debit,52982.08,,system,2025-06-08 17:17:13.594087,system,2025-06-08 17:17:13.594087
a25d798cca1e493692d07ce32ffc806d,6a95eeecbcaf44e49ed2dd23179fa64e,2024-12-14,Involve cold recent right buy cover eye young.,-728.59,Debit,52253.49,,system,2025-06-08 17:17:13.594087,system,2025-06-08 17:17:13.594087
3dca4a44aedd48e399ad9da718408d27,6a95eeecbcaf44e49ed2dd23179fa64e,2025-01-29,Benefit as media miss big.,3667.74,Credit,55921.23,,system,2025-06-08 17:17:13.594087,system,2025-06-08 17:17:13.594087
a7bbec45b85646918ed3b634d6326b94,6a95eeecbcaf44e49ed2dd23179fa64e,2025-02-27,Traditional sound matter.,-47.6,Debit,55873.63,,system,2025-06-08 17:17:13.594087,system,2025-06-08 17:17:13.594087
eff3dfd3ae034441b4967f8f28913e71,6a95eeecbcaf44e49ed2dd23179fa64e,2025-05-07,Next test despite civil.,3697.33,Credit,59570.96,,system,2025-06-08 17:17:13.594087,system,2025-06-08 17:17:13.594087
60fec1e9ce404df39949be01be912a2c,6a95eeecbcaf44e49ed2dd23179fa64e,2025-01-21,Data natural I coach fine your including.,1582.02,Credit,61152.98,,system,2025-06-08 17:17:13.594087,system,2025-06-08 17:17:13.594087
2a47c636ab7d451a9776617af0542a0d,f52a91f89ccf4d4d9451546e5e462667,2025-04-14,Walk lay type friend hundred your plant class.,3104.91,Credit,53104.91,,system,2025-06-08 17:17:13.594087,system,2025-06-08 17:17:13.594087
d1dead204b724f88911a0de698575ac1,f52a91f89ccf4d4d9451546e5e462667,2025-04-09,Yes poor list create worry.,-908.33,Debit,52196.58,,system,2025-06-08 17:17:13.594087,system,2025-06-08 17:17:13.594087
e52367c5b28d47029c742078023b9324,f52a91f89ccf4d4d9451546e5e462667,2025-01-25,Visit range with sister.,-675.58,Debit,51521.0,,system,2025-06-08 17:17:13.594087,system,2025-06-08 17:17:13.594087
d310f2def1da422c929e1b20cfe329b3,f52a91f89ccf4d4d9451546e5e462667,2024-12-20,Which how executive risk future energy.,4060.52,Credit,55581.52,,system,2025-06-08 17:17:13.594087,system,2025-06-08 17:17:13.594087
a834ff767e7e4cb297c5facac8b63aed,f52a91f89ccf4d4d9451546e5e462667,2025-05-17,Method large campaign himself source level.,-1424.65,Debit,54156.87,,system,2025-06-08 17:17:13.594087,system,2025-06-08 17:17:13.594087
14104349a6384e44bc5bcc3f91853bb0,f52a91f89ccf4d4d9451546e5e462667,2025-02-27,Each check almost wrong defense.,2287.1,Credit,56443.97,,system,2025-06-08 17:17:13.594087,system,2025-06-08 17:17:13.594087
2386ced08bdc42399580d11f4fcd1fe8,f52a91f89ccf4d4d9451546e5e462667,2024-12-27,Accept I director ask.,3790.98,Credit,60234.95,,system,2025-06-08 17:17:13.594087,system,2025-06-08 17:17:13.594087
01caf2e6f847440e9bbd01bc7df95e61,f52a91f89ccf4d4d9451546e5e462667,2025-02-26,Less fund why center probably part.,-3385.35,Debit,56849.6,,system,2025-06-08 17:17:13.594087,system,2025-06-08 17:17:13.594087
da11b7fb42104f57bfef5dd50ebec095,f52a91f89ccf4d4d9451546e5e462667,2025-04-29,Fund notice budget forget provide west fact ten.,-3281.02,Debit,53568.58,,system,2025-06-08 17:17:13.594087,system,2025-06-08 17:17:13.594087
4497162ae0364a5c9fc8fa7d47e5412e,f52a91f89ccf4d4d9451546e5e462667,2025-02-18,Senior recent agree national later animal.,-3159.25,Debit,50409.33,,system,2025-06-08 17:17:13.594087,system,2025-06-08 17:17:13.594087
7137d6a561eb44099e97c1a4b7853d0c,028e1b6e5c0744a4b29403410d184552,2025-01-28,Land voice follow individual.,-650.19,Debit,49349.81,,system,2025-06-08 17:17:13.594087,system,2025-06-08 17:17:13.594087
ea95b9f99e214ada81541d75d3b33a0f,028e1b6e5c0744a4b29403410d184552,2025-01-28,Another both less in company if.,3308.03,Credit,52657.84,,system,2025-06-08 17:17:13.594087,system,2025-06-08 17:17:13.594087
0c8a4de00c7146fea4481cd00d70ae7a,028e1b6e5c0744a4b29403410d184552,2024-12-11,Character strategy boy perform attack news add cost.,-4888.07,Debit,47769.77,,system,2025-06-08 17:17:13.594087,system,2025-06-08 17:17:13.594087
82e5fe3f53544b1fb75be36fb6fb44e3,028e1b6e5c0744a4b29403410d184552,2025-02-14,Meeting main type glass hour campaign first total.,1877.87,Credit,49647.64,,system,2025-06-08 17:17:13.594087,system,2025-06-08 17:17:13.594087
3853db96cdb14180b809a7251ee6fbce,028e1b6e5c0744a4b29403410d184552,2025-05-18,International other give tough.,1435.81,Credit,51083.45,,system,2025-06-08 17:17:13.594087,system,2025-06-08 17:17:13.594087
ed8fabae87184115b1f7a28109a16dfa,028e1b6e5c0744a4b29403410d184552,2025-03-17,However able book strong focus.,4496.02,Credit,55579.47,,system,2025-06-08 17:17:13.594087,system,2025-06-08 17:17:13.594087
03a6ba27e3ed4191b27afdb1d27c147e,028e1b6e5c0744a4b29403410d184552,2025-01-19,Surface fall nor know environmental remember soon candidate.,-3309.92,Debit,52269.55,,system,2025-06-08 17:17:13.594087,system,2025-06-08 17:17:13.594087
a68dd5dfd0144727b517073067f65afc,028e1b6e5c0744a4b29403410d184552,2025-01-05,Sure evidence morning maybe sense yourself live.,4167.77,Credit,56437.32,,system,2025-06-08 17:17:13.594087,system,2025-06-08 17:17:13.594087
fd85db26defc4d83b05c2c9a2ea0127e,028e1b6e5c0744a4b29403410d184552,2025-01-22,Meeting here accept their speak national space.,1759.78,Credit,58197.1,,system,2025-06-08 17:17:13.594087,system,2025-06-08 17:17:13.594087
d71cb1f33e684d8bb4ff138e2820e191,028e1b6e5c0744a4b29403410d184552,2025-06-08,Though floor artist area actually build hit.,4674.56,Credit,62871.66,,system,2025-06-08 17:17:13.594087,system,2025-06-08 17:17:13.594087
a2b441f9fc7e4a68ac4e7fa5254a1159,039e785cd96545f682b07b3acab569bb,2025-01-11,Born particular crime life.,-362.0,Debit,49638.0,,system,2025-06-08 17:17:13.594087,system,2025-06-08 17:17:13.594087
cee686d6b5b247dc83f09f6fff956118,039e785cd96545f682b07b3acab569bb,2025-03-19,Doctor television air if seem mind hospital.,837.32,Credit,50475.32,,system,2025-06-08 17:17:13.594087,system,2025-06-08 17:17:13.594087
2b0c4ce4e4a543bcba5584926c53b117,039e785cd96545f682b07b3acab569bb,2025-05-12,Fill chair number by seek adult.,656.01,Credit,51131.33,,system,2025-06-08 17:17:13.594087,system,2025-06-08 17:17:13.594087
33c2a69247984b3eab74e9c5cff6b605,039e785cd96545f682b07b3acab569bb,2025-03-13,Father share piece physical.,-3644.21,Debit,47487.12,,system,2025-06-08 17:17:13.594087,system,2025-06-08 17:17:13.594087
6c814acf0fc44179af0f48e9935cfa6d,039e785cd96545f682b07b3acab569bb,2025-02-06,Quality soon believe open audience.,1224.87,Credit,48711.99,,system,2025-06-08 17:17:13.594087,system,2025-06-08 17:17:13.594087
565cd5fa3ce04f458073f5e42eae8e46,039e785cd96545f682b07b3acab569bb,2025-02-17,List group goal than.,-351.47,Debit,48360.52,,system,2025-06-08 17:17:13.594087,system,2025-06-08 17:17:13.594087
abc4f77ab73b4d2f95f3c1ad58887950,039e785cd96545f682b07b3acab569bb,2025-01-05,Mr easy TV magazine single probably sing.,-1772.84,Debit,46587.68,,system,2025-06-08 17:17:13.594087,system,2025-06-08 17:17:13.594087
6e0b3ab249d740f9ab264e043e92689b,039e785cd96545f682b07b3acab569bb,2025-03-03,Available Mr sell likely doctor player.,3359.46,Credit,49947.14,,system,2025-06-08 17:17:13.594087,system,2025-06-08 17:17:13.594087
a4c33f95e4b14bfb98bf0178523d12f2,039e785cd96545f682b07b3acab569bb,2025-01-19,Claim piece your health.,-2036.14,Debit,47911.0,,system,2025-06-08 17:17:13.594087,system,2025-06-08 17:17:13.594087
4692bdb996ed46ef9fb95a04b41b6978,039e785cd96545f682b07b3acab569bb,2025-01-17,Name draw buy consider half spend chance.,3386.05,Credit,51297.05,,system,2025-06-08 17:17:13.594087,system,2025-06-08 17:17:13.594087
34e71d0ca02b4db7b33270540da16c68,78d899caf6174ad2befd78b37dfc4c0d,2025-01-23,Star arrive another foreign usually policy pull.,-1306.42,Debit,48693.58,,system,2025-06-08 17:17:13.594087,system,2025-06-08 17:17:13.594087
17fb5953e56440a5a8f913e58164820c,78d899caf6174ad2befd78b37dfc4c0d,2025-06-01,Tax between firm rise main three agency.,-4753.63,Debit,43939.95,,system,2025-06-08 17:17:13.594087,system,2025-06-08 17:17:13.594087
bcba5a3c2f5e4496adddaca0e958a2a9,78d899caf6174ad2befd78b37dfc4c0d,2025-03-26,Yet sometimes drug party.,4242.78,Credit,48182.73,,system,2025-06-08 17:17:13.594087,system,2025-06-08 17:17:13.594087
e6a4385cf3c24aee8a2f2c8ffeb3bb67,78d899caf6174ad2befd78b37dfc4c0d,2025-02-16,Policy list husband reveal.,-3752.02,Debit,44430.71,,system,2025-06-08 17:17:13.594087,system,2025-06-08 17:17:13.594087
73f540f766514571aa55f4388f316629,78d899caf6174ad2befd78b37dfc4c0d,2025-03-01,Worker same collection exactly administration be.,-3906.4,Debit,40524.31,,system,2025-06-08 17:17:13.594087,system,2025-06-08 17:17:13.594087
e88c26ca3c964e0bae084b928008cf19,78d899caf6174ad2befd78b37dfc4c0d,2025-01-18,Mouth product dog likely right identify help.,-1703.39,Debit,38820.92,,system,2025-06-08 17:17:13.594087,system,2025-06-08 17:17:13.594087
c61003fb12e341d29927d9324f305532,78d899caf6174ad2befd78b37dfc4c0d,2025-01-13,Statement option science.,827.12,Credit,39648.04,,system,2025-06-08 17:17:13.594087,system,2025-06-08 17:17:13.594087
cf297f0c440841dca72f0b6c8a5ed4b7,78d899caf6174ad2befd78b37dfc4c0d,2025-05-04,End test production.,-4300.29,Debit,35347.75,,system,2025-06-08 17:17:13.594087,system,2025-06-08 17:17:13.594087
60fd514b4a724ce087c715f475845613,78d899caf6174ad2befd78b37dfc4c0d,2025-03-10,Understand almost team.,902.31,Credit,36250.06,,system,2025-06-08 17:17:13.594087,system,2025-06-08 17:17:13.594087
8a4da9c19ce94b8bb3772f27b174c3da,78d899caf6174ad2befd78b37dfc4c0d,2025-03-11,Care maintain run let this from though turn.,3674.03,Credit,39924.09,,system,2025-06-08 17:17:13.594087,system,2025-06-08 17:17:13.594087
8ef263fdee6e43e081554da1b797efff,d3f2cd8a86124dc39e1373594ac54d01,2025-01-23,Medical friend church from herself those main.,3014.32,Credit,53014.32,,system,2025-06-08 17:17:13.594087,system,2025-06-08 17:17:13.594087
006262f237424ec2994ab52f684f01df,d3f2cd8a86124dc39e1373594ac54d01,2025-05-19,Why right box huge after time section.,328.77,Credit,53343.09,,system,2025-06-08 17:17:13.594087,system,2025-06-08 17:17:13.594087
96bb273ec0574387bfb7e5efa7512825,d3f2cd8a86124dc39e1373594ac54d01,2025-03-22,Against white type choice television policy hot.,1482.87,Credit,54825.96,,system,2025-06-08 17:17:13.594087,system,2025-06-08 17:17:13.594087
a691a4990c8a45779f743075e2baf953,d3f2cd8a86124dc39e1373594ac54d01,2025-05-29,Morning order lay.,255.82,Credit,55081.78,,system,2025-06-08 17:17:13.594087,system,2025-06-08 17:17:13.594087
1f82bec7d101469fab63e51a5a833e9d,d3f2cd8a86124dc39e1373594ac54d01,2024-12-24,Apply market too call.,-4439.18,Debit,50642.6,,system,2025-06-08 17:17:13.594087,system,2025-06-08 17:17:13.594087
ed74f6488f4642e78b763d7ba395bda7,d3f2cd8a86124dc39e1373594ac54d01,2025-05-28,Most member policy report agree.,-1389.39,Debit,49253.21,,system,2025-06-08 17:17:13.594087,system,2025-06-08 17:17:13.594087
e085745b41cb43b1b34221599d1b4286,d3f2cd8a86124dc39e1373594ac54d01,2025-01-05,Speech single word before.,-4956.37,Debit,44296.84,,system,2025-06-08 17:17:13.594087,system,2025-06-08 17:17:13.594087
817ac51443924ea3ac50caf5d69d7d13,d3f2cd8a86124dc39e1373594ac54d01,2025-03-31,Degree improve happen author woman.,-3163.64,Debit,41133.2,,system,2025-06-08 17:17:13.594087,system,2025-06-08 17:17:13.594087
8bd3a3db7dbc4d53b9744f331119b8ee,d3f2cd8a86124dc39e1373594ac54d01,2024-12-27,Enjoy mother huge argue former believe house simply.,943.66,Credit,42076.86,,system,2025-06-08 17:17:13.594087,system,2025-06-08 17:17:13.594087
715a92dd0d1548fc9ea38ed281894299,d3f2cd8a86124dc39e1373594ac54d01,2025-02-14,Party maintain city down painting.,-3190.53,Debit,38886.33,,system,2025-06-08 17:17:13.594087,system,2025-06-08 17:17:13.594087
4a36051f8da949c78b85e65929bb2816,2bc0cbde5bd7432faddee13e0e1a58d5,2025-02-03,At owner teacher.,611.78,Credit,50611.78,,system,2025-06-08 17:17:13.594087,system,2025-06-08 17:17:13.594087
1e78d82851c949318c5afaaba51ac945,2bc0cbde5bd7432faddee13e0e1a58d5,2025-02-10,Organization miss account weight page church sometimes.,-1504.19,Debit,49107.59,,system,2025-06-08 17:17:13.594087,system,2025-06-08 17:17:13.594087
847d6a6a88d64460b937ed62f45079b3,2bc0cbde5bd7432faddee13e0e1a58d5,2024-12-30,Somebody product section figure serious walk tough.,4924.18,Credit,54031.77,,system,2025-06-08 17:17:13.594087,system,2025-06-08 17:17:13.594087
7472a9f857d44521a07960d9fc4b26f6,2bc0cbde5bd7432faddee13e0e1a58d5,2025-06-04,Daughter half culture phone whether evidence.,-2670.85,Debit,51360.92,,system,2025-06-08 17:17:13.594087,system,2025-06-08 17:17:13.594087
2549ebcc1c94459193bfa8a2d8b1eadc,2bc0cbde5bd7432faddee13e0e1a58d5,2025-01-09,Form mission trouble mission.,2739.41,Credit,54100.33,,system,2025-06-08 17:17:13.594087,system,2025-06-08 17:17:13.594087
0f0337fe6b54481da44fae3070518ddb,2bc0cbde5bd7432faddee13e0e1a58d5,2025-05-08,Kind here deal seek.,-3038.23,Debit,51062.1,,system,2025-06-08 17:17:13.594087,system,2025-06-08 17:17:13.594087
b29d619e9e814f63ba1ef3203e456927,2bc0cbde5bd7432faddee13e0e1a58d5,2025-05-01,Sport score else any.,-3983.25,Debit,47078.85,,system,2025-06-08 17:17:13.594087,system,2025-06-08 17:17:13.594087
e1bd0d4875c5423cb561debd3f5c28e6,2bc0cbde5bd7432faddee13e0e1a58d5,2025-06-05,Couple expect phone alone.,-1601.05,Debit,45477.8,,system,2025-06-08 17:17:13.594087,system,2025-06-08 17:17:13.594087
294461730a3a4aacac7f4680ca79ac02,2bc0cbde5bd7432faddee13e0e1a58d5,2025-01-30,Action seek edge hundred indeed style.,-4361.92,Debit,41115.88,,system,2025-06-08 17:17:13.594087,system,2025-06-08 17:17:13.594087
7aea18ac61db477797f365fed3610e87,2bc0cbde5bd7432faddee13e0e1a58d5,2024-12-30,Send through myself decision moment before.,-1085.75,Debit,40030.13,,system,2025-06-08 17:17:13.594087,system,2025-06-08 17:17:13.594087
295c3c1f335b47d28842b76fd68211f8,d5761022615e457aa42f7507fcbcd5f5,2025-03-30,Surface guy notice apply green wrong speech.,-4638.71,Debit,45361.29,,system,2025-06-08 17:17:13.594087,system,2025-06-08 17:17:13.594087
cd9ace59007d4f439145456d563bd834,d5761022615e457aa42f7507fcbcd5f5,2025-06-03,Lawyer suddenly image series thank use ten.,-3290.85,Debit,42070.44,,system,2025-06-08 17:17:13.594087,system,2025-06-08 17:17:13.594087
d876c0c559a84e39859aa758048f8a11,d5761022615e457aa42f7507fcbcd5f5,2024-12-26,Partner speak dinner history can.,-985.0,Debit,41085.44,,system,2025-06-08 17:17:13.594087,system,2025-06-08 17:17:13.594087
9e93967ac83d4382bc6123db9a083dc7,d5761022615e457aa42f7507fcbcd5f5,2025-05-01,Movie rather they hair always politics dream what.,1007.27,Credit,42092.71,,system,2025-06-08 17:17:13.594087,system,2025-06-08 17:17:13.594087
0456b1b4e2fb4310ab4bb44d7e923268,d5761022615e457aa42f7507fcbcd5f5,2025-04-28,Skill lay bed.,4954.64,Credit,47047.35,,system,2025-06-08 17:17:13.594087,system,2025-06-08 17:17:13.594087
ab37a0c2722442fea9ccebc2e88bca25,d5761022615e457aa42f7507fcbcd5f5,2025-04-21,Sure ok with.,-2729.38,Debit,44317.97,,system,2025-06-08 17:17:13.594087,system,2025-06-08 17:17:13.594087
f723b4d114e843f1a4bb798b8185cbaa,d5761022615e457aa42f7507fcbcd5f5,2025-04-16,Until concern senior perhaps man training.,-919.26,Debit,43398.71,,system,2025-06-08 17:17:13.594087,system,2025-06-08 17:17:13.594087
9d52cf04b24a4314bacbacedbe49aeb1,d5761022615e457aa42f7507fcbcd5f5,2024-12-28,Smile fact during fire.,3208.4,Credit,46607.11,,system,2025-06-08 17:17:13.594087,system,2025-06-08 17:17:13.594087
c7e4e935a7aa4576b9380dc05e7c8251,d5761022615e457aa42f7507fcbcd5f5,2025-03-02,Rise carry quickly.,607.93,Credit,47215.04,,system,2025-06-08 17:17:13.594087,system,2025-06-08 17:17:13.594087
e977676c73ba440ab5b7fb9a24a8f5cc,d5761022615e457aa42f7507fcbcd5f5,2025-05-29,Exactly beautiful reason despite important cold state direction.,-3318.52,Debit,43896.52,,system,2025-06-08 17:17:13.594087,system,2025-06-08 17:17:13.594087
74601deb803543a4adea4324b6e464cb,54d561985578419cbe9c73686e91d907,2025-02-01,Have decade not possible describe budget.,-4863.6,Debit,45136.4,,system,2025-06-08 17:17:13.594087,system,2025-06-08 17:17:13.594087
e607a1cc7dfa43589ffefd622439d5fe,54d561985578419cbe9c73686e91d907,2025-06-03,Current put include receive what tell two.,1389.39,Credit,46525.79,,system,2025-06-08 17:17:13.594087,system,2025-06-08 17:17:13.594087
956338dc683a4213b0946b8b9e033642,54d561985578419cbe9c73686e91d907,2025-04-03,Including statement recognize computer say property soon.,4404.2,Credit,50929.99,,system,2025-06-08 17:17:13.594087,system,2025-06-08 17:17:13.594087
6018132d51e54b3685fda116b8abbeb7,54d561985578419cbe9c73686e91d907,2025-03-02,Act PM indicate reach born.,2854.96,Credit,53784.95,,system,2025-06-08 17:17:13.594087,system,2025-06-08 17:17:13.594087
24db55b64afa4d48afb28cd4430062e8,54d561985578419cbe9c73686e91d907,2025-02-20,Teacher risk order piece art.,1512.08,Credit,55297.03,,system,2025-06-08 17:17:13.594087,system,2025-06-08 17:17:13.594087
e64063e257674ab6aada62e2b8ef0bad,54d561985578419cbe9c73686e91d907,2024-12-11,Build give example we manager dinner its.,-3611.07,Debit,51685.96,,system,2025-06-08 17:17:13.594087,system,2025-06-08 17:17:13.594087
0573a2bb61f64a5d82ca892cbb62b1cc,54d561985578419cbe9c73686e91d907,2025-02-13,Book partner enough stop ball mission political.,3049.3,Credit,54735.26,,system,2025-06-08 17:17:13.594087,system,2025-06-08 17:17:13.594087
5ea174071b144332993c8d93f0d0325e,54d561985578419cbe9c73686e91d907,2025-02-08,Hand possible establish radio instead card ready hair.,-1365.2,Debit,53370.06,,system,2025-06-08 17:17:13.594087,system,2025-06-08 17:17:13.594087
c3e032bc6f4e4ffb98e149a1306e6df6,54d561985578419cbe9c73686e91d907,2024-12-28,Company knowledge win shoulder.,4451.91,Credit,57821.97,,system,2025-06-08 17:17:13.594087,system,2025-06-08 17:17:13.594087
684a36b28616486bb63d7e77d8ad1dca,54d561985578419cbe9c73686e91d907,2025-06-02,Less kid during save control woman through.,-2117.2,Debit,55704.77,,system,2025-06-08 17:17:13.594087,system,2025-06-08 17:17:13.594087
6c98bedc2b304e26beccfb9a20f31e93,717867faa93b461ab30562018ae22b00,2025-03-17,Scientist detail east finally finish.,1972.86,Credit,51972.86,,system,2025-06-08 17:17:13.594087,system,2025-06-08 17:17:13.594087
848304c599064f79b71004711b4ac30f,717867faa93b461ab30562018ae22b00,2024-12-14,Create financial it sell receive.,-51.82,Debit,51921.04,,system,2025-06-08 17:17:13.594087,system,2025-06-08 17:17:13.594087
8893072ef92f4d7fa46375dccb91b576,717867faa93b461ab30562018ae22b00,2024-12-26,Lay spend series attention sea sister area long.,-4079.78,Debit,47841.26,,system,2025-06-08 17:17:13.594087,system,2025-06-08 17:17:13.594087
eda2fbc1e67742a1b34117124e6e38ba,717867faa93b461ab30562018ae22b00,2025-03-22,Often key TV type.,2626.4,Credit,50467.66,,system,2025-06-08 17:17:13.594087,system,2025-06-08 17:17:13.594087
656e963fa8d649c599132eee731b7f3c,717867faa93b461ab30562018ae22b00,2024-12-21,Once agreement method fund remember she structure.,-1089.72,Debit,49377.94,,system,2025-06-08 17:17:13.594087,system,2025-06-08 17:17:13.594087
24a26df27bbf4c0b81a013b984d15839,717867faa93b461ab30562018ae22b00,2025-03-06,Physical speech section serve.,4610.31,Credit,53988.25,,system,2025-06-08 17:17:13.594087,system,2025-06-08 17:17:13.594087
cb83e5120b5248539cb8cee19abc6732,717867faa93b461ab30562018ae22b00,2024-12-17,Strategy service common candidate.,4012.91,Credit,58001.16,,system,2025-06-08 17:17:13.594087,system,2025-06-08 17:17:13.594087
ebbc623f68ca4aa28ae4f0b1bcc36665,717867faa93b461ab30562018ae22b00,2025-02-02,Wide blue them safe.,2769.73,Credit,60770.89,,system,2025-06-08 17:17:13.594087,system,2025-06-08 17:17:13.594087
616bdfabf39149f09f825c0178905bed,717867faa93b461ab30562018ae22b00,2025-03-03,Order issue campaign admit.,-2442.88,Debit,58328.01,,system,2025-06-08 17:17:13.594087,system,2025-06-08 17:17:13.594087
eda84cb7f15c4c79bcaf636dcc5c3fe2,717867faa93b461ab30562018ae22b00,2025-02-02,Government call base finish think.,427.5,Credit,58755.51,,system,2025-06-08 17:17:13.594087,system,2025-06-08 17:17:13.594087
5f632918f7b34cc2a5361cccfb429e4c,7dffdf1ebb804b659729ef5cccc1d25b,2025-03-08,Describe general miss example that statement allow.,2889.86,Credit,52889.86,,system,2025-06-08 17:17:13.594087,system,2025-06-08 17:17:13.594087
b2f02e1912884967976b248513704511,7dffdf1ebb804b659729ef5cccc1d25b,2025-04-05,Over work agency few lead police father.,1459.41,Credit,54349.27,,system,2025-06-08 17:17:13.594087,system,2025-06-08 17:17:13.594087
8e7c9cb696974accbd2a04f3ea95ee63,7dffdf1ebb804b659729ef5cccc1d25b,2025-04-13,Deep than reality.,4397.44,Credit,58746.71,,system,2025-06-08 17:17:13.594087,system,2025-06-08 17:17:13.594087
de58fef2248e45298032a3d14971e4ac,7dffdf1ebb804b659729ef5cccc1d25b,2025-05-23,Anything business situation capital.,-2456.14,Debit,56290.57,,system,2025-06-08 17:17:13.594087,system,2025-06-08 17:17:13.594087
01d3649269cd40c782c9bec1d2e711d1,7dffdf1ebb804b659729ef5cccc1d25b,2024-12-23,Bank act likely.,-2193.13,Debit,54097.44,,system,2025-06-08 17:17:13.594087,system,2025-06-08 17:17:13.594087
557143367d7040e5b43c5870cca5ae71,7dffdf1ebb804b659729ef5cccc1d25b,2025-01-19,Matter teacher sure south campaign.,-708.63,Debit,53388.81,,system,2025-06-08 17:17:13.594087,system,2025-06-08 17:17:13.594087
acb064bbe4a849e5aeb816124236b071,7dffdf1ebb804b659729ef5cccc1d25b,2024-12-21,Various same fine card these poor who one.,4751.83,Credit,58140.64,,system,2025-06-08 17:17:13.594087,system,2025-06-08 17:17:13.594087
bfb03a12ebee4c21ba724edbd486cd3e,7dffdf1ebb804b659729ef5cccc1d25b,2025-03-10,Society drug arrive level half its her difference.,3227.21,Credit,61367.85,,system,2025-06-08 17:17:13.594087,system,2025-06-08 17:17:13.594087
d5d54f4f22cc48389bf6fceb069d6471,7dffdf1ebb804b659729ef5cccc1d25b,2025-01-28,Purpose force radio back manage treat.,4274.78,Credit,65642.63,,system,2025-06-08 17:17:13.594087,system,2025-06-08 17:17:13.594087
674ebade2146424cbbd2bbd8cb4b4abd,7dffdf1ebb804b659729ef5cccc1d25b,2025-04-01,Apply fear star.,-3013.73,Debit,62628.9,,system,2025-06-08 17:17:13.594087,system,2025-06-08 17:17:13.594087
d750571b1aca4dd382554e33eb782a63,349f4e2d7346413795ed55fedc5ef230,2025-03-25,Figure three president it suggest partner big.,66.77,Credit,50066.77,,system,2025-06-08 17:17:13.594087,system,2025-06-08 17:17:13.594087
31bcb052871c47d19a63fe8911efc3ac,349f4e2d7346413795ed55fedc5ef230,2025-04-11,Bag form guy surface allow.,615.64,Credit,50682.41,,system,2025-06-08 17:17:13.594087,system,2025-06-08 17:17:13.594087
c6b0d97c415643ccacc1715d1b74e87e,349f4e2d7346413795ed55fedc5ef230,2025-03-10,Condition question wall adult.,1613.5,Credit,52295.91,,system,2025-06-08 17:17:13.594087,system,2025-06-08 17:17:13.594087
977d7c26e1fd4f3bbabc8e3a4ccf9d57,349f4e2d7346413795ed55fedc5ef230,2025-02-19,Else court professional.,1549.14,Credit,53845.05,,system,2025-06-08 17:17:13.594087,system,2025-06-08 17:17:13.594087
36269b74568b4e4bbe93410d14d9f752,349f4e2d7346413795ed55fedc5ef230,2025-02-22,Some claim prevent wind official debate.,1299.81,Credit,55144.86,,system,2025-06-08 17:17:13.594087,system,2025-06-08 17:17:13.594087
158cc6bc6c0842bb9a6ff5a944ac30ad,349f4e2d7346413795ed55fedc5ef230,2025-04-14,Sometimes position consider eight though now hold.,3321.25,Credit,58466.11,,system,2025-06-08 17:17:13.594087,system,2025-06-08 17:17:13.594087
6790fea4cd034cde97eaa78dc870918e,349f4e2d7346413795ed55fedc5ef230,2025-02-28,Last south nature major address world she.,-658.23,Debit,57807.88,,system,2025-06-08 17:17:13.594087,system,2025-06-08 17:17:13.594087
a23ea3aaf7334231a5875d60bcebbc7f,349f4e2d7346413795ed55fedc5ef230,2025-01-27,Morning others few type represent sister sort.,3298.7,Credit,61106.58,,system,2025-06-08 17:17:13.594087,system,2025-06-08 17:17:13.594087
817e7ed37ced4ff893bcfef47e9d0723,349f4e2d7346413795ed55fedc5ef230,2025-04-30,End social pass.,-1868.1,Debit,59238.48,,system,2025-06-08 17:17:13.594087,system,2025-06-08 17:17:13.594087
adc32c08af184744b6e3825a8d145538,349f4e2d7346413795ed55fedc5ef230,2024-12-21,Article model onto some.,-4707.01,Debit,54531.47,,system,2025-06-08 17:17:13.594087,system,2025-06-08 17:17:13.594087
c16ffb87cc8847599dee45ec30ba9df2,54a9f8fc231141569f6a1b6cfc471916,2025-02-07,Green too watch way third political.,3114.04,Credit,53114.04,,system,2025-06-08 17:17:13.594087,system,2025-06-08 17:17:13.594087
12d5c23dcef1456589d25067c7a67126,54a9f8fc231141569f6a1b6cfc471916,2025-02-08,Compare campaign less provide these.,-1350.81,Debit,51763.23,,system,2025-06-08 17:17:13.594087,system,2025-06-08 17:17:13.594087
d220a0de38af402994962b8344941ef1,54a9f8fc231141569f6a1b6cfc471916,2025-01-29,Society accept far significant represent place.,-4954.25,Debit,46808.98,,system,2025-06-08 17:17:13.594087,system,2025-06-08 17:17:13.594087
b284d541c7b04a3daf2c0714f2793ce3,54a9f8fc231141569f6a1b6cfc471916,2025-03-26,Total past bag power develop.,4010.92,Credit,50819.9,,system,2025-06-08 17:17:13.594087,system,2025-06-08 17:17:13.594087
e62f595d16a54e3388e7811fd32ed699,54a9f8fc231141569f6a1b6cfc471916,2024-12-24,Pressure feeling analysis nothing discuss.,-2562.97,Debit,48256.93,,system,2025-06-08 17:17:13.594087,system,2025-06-08 17:17:13.594087
33a30f6cb9aa47ebae15e206e962249d,54a9f8fc231141569f6a1b6cfc471916,2025-01-03,Opportunity kid chair store result guy happy.,-914.87,Debit,47342.06,,system,2025-06-08 17:17:13.594087,system,2025-06-08 17:17:13.594087
78554519d0044f8598e532b0a5b3d7bf,54a9f8fc231141569f6a1b6cfc471916,2024-12-22,Whom memory size.,608.53,Credit,47950.59,,system,2025-06-08 17:17:13.594087,system,2025-06-08 17:17:13.594087
eb2cf9036fad44ee8e15d4cfff722760,54a9f8fc231141569f6a1b6cfc471916,2025-04-05,Education green finish green stuff.,3291.21,Credit,51241.8,,system,2025-06-08 17:17:13.594087,system,2025-06-08 17:17:13.594087
0b9fa3fb93d845ed8b469fc19df7713c,54a9f8fc231141569f6a1b6cfc471916,2025-02-18,Put federal popular maybe management machine.,-1992.34,Debit,49249.46,,system,2025-06-08 17:17:13.594087,system,2025-06-08 17:17:13.594087
fc63d2e0ed3145bdaeaccc6c000826c9,54a9f8fc231141569f6a1b6cfc471916,2024-12-14,So popular they away play design.,4968.17,Credit,54217.63,,system,2025-06-08 17:17:13.594087,system,2025-06-08 17:17:13.594087
55f8cf63cde0475eb2fee017ce5f20f9,369f73a5ba1c421ca9a3436166b446be,2025-01-22,Up training nor skin school key.,-1627.84,Debit,48372.16,,system,2025-06-08 17:17:13.594087,system,2025-06-08 17:17:13.594087
004f701bea314a00a568fcb269312691,369f73a5ba1c421ca9a3436166b446be,2025-06-02,Street peace south.,-4683.26,Debit,43688.9,,system,2025-06-08 17:17:13.594087,system,2025-06-08 17:17:13.594087
bc841c1b982340e7a7f63e6b997c3347,369f73a5ba1c421ca9a3436166b446be,2025-03-22,Former analysis step live analysis.,2631.59,Credit,46320.49,,system,2025-06-08 17:17:13.594087,system,2025-06-08 17:17:13.594087
b0ce467f41f24027aee39a15d42b46d8,369f73a5ba1c421ca9a3436166b446be,2025-05-24,Run right blue.,-1808.73,Debit,44511.76,,system,2025-06-08 17:17:13.594087,system,2025-06-08 17:17:13.594087
af4d54b3b87a41d898482b052d447ade,369f73a5ba1c421ca9a3436166b446be,2025-05-31,And pass throw before research challenge participant.,-1388.22,Debit,43123.54,,system,2025-06-08 17:17:13.594087,system,2025-06-08 17:17:13.594087
38602ddda5464bc6839ebfe24b4ef47d,369f73a5ba1c421ca9a3436166b446be,2025-01-23,Its player art deal kitchen result picture.,958.81,Credit,44082.35,,system,2025-06-08 17:17:13.594087,system,2025-06-08 17:17:13.594087
846e65ba83d747d1957ce9ce87dca102,369f73a5ba1c421ca9a3436166b446be,2025-02-10,News to sure more direction treatment notice.,-2308.6,Debit,41773.75,,system,2025-06-08 17:17:13.594087,system,2025-06-08 17:17:13.594087
f95714416d4049cc9ced759ad28f5317,369f73a5ba1c421ca9a3436166b446be,2025-06-06,Than rule arm behavior.,-3348.15,Debit,38425.6,,system,2025-06-08 17:17:13.594087,system,2025-06-08 17:17:13.594087
4c34e754830241339b0a3dee59c1b4c6,369f73a5ba1c421ca9a3436166b446be,2025-04-19,Nice win floor community other capital.,-4488.63,Debit,33936.97,,system,2025-06-08 17:17:13.594087,system,2025-06-08 17:17:13.594087
b962fd23b088453e8e27dff583e43735,369f73a5ba1c421ca9a3436166b446be,2025-01-05,High environment according anything speak.,-2196.36,Debit,31740.61,,system,2025-06-08 17:17:13.594087,system,2025-06-08 17:17:13.594087
ba8eb68c70184dd5a7965f0a1e0b9bb2,fe582ff24a7a4a9e85deb76bdd497f14,2025-01-14,Single outside they which.,2584.87,Credit,52584.87,,system,2025-06-08 17:17:13.594087,system,2025-06-08 17:17:13.594087
d674a00bc3054cc49047d310f00e9523,fe582ff24a7a4a9e85deb76bdd497f14,2025-02-09,Family your inside.,-4543.22,Debit,48041.65,,system,2025-06-08 17:17:13.594087,system,2025-06-08 17:17:13.594087
38a99c32fe0f48a4af475af21723724f,fe582ff24a7a4a9e85deb76bdd497f14,2025-02-03,Among several across ten state across remain.,-531.63,Debit,47510.02,,system,2025-06-08 17:17:13.594087,system,2025-06-08 17:17:13.594087
2354a6b7c96e4e8d8ded471d1eba784c,fe582ff24a7a4a9e85deb76bdd497f14,2025-01-08,Myself strong use movie full.,4069.85,Credit,51579.87,,system,2025-06-08 17:17:13.603454,system,2025-06-08 17:17:13.603454
c7483e361bad422eb3e2fadd4e23df2a,fe582ff24a7a4a9e85deb76bdd497f14,2024-12-28,Remember thousand game glass kitchen goal trouble instead.,-1852.68,Debit,49727.19,,system,2025-06-08 17:17:13.603454,system,2025-06-08 17:17:13.603454
634f0c71d9ba4fedb50c37c74b610451,fe582ff24a7a4a9e85deb76bdd497f14,2025-03-12,Newspaper staff yes wide window animal writer.,2884.69,Credit,52611.88,,system,2025-06-08 17:17:13.603454,system,2025-06-08 17:17:13.603454
c3fbe016aad34586ad8b45e7138632b2,fe582ff24a7a4a9e85deb76bdd497f14,2024-12-15,Even some four thought cell.,1669.54,Credit,54281.42,,system,2025-06-08 17:17:13.603454,system,2025-06-08 17:17:13.603454
93772aeaa22443bb961d72e7624f945b,fe582ff24a7a4a9e85deb76bdd497f14,2025-01-16,Bar billion whose various none decide partner.,-4952.13,Debit,49329.29,,system,2025-06-08 17:17:13.603454,system,2025-06-08 17:17:13.603454
6a5b87ad8a364b1da2ddcfa3cb44f205,fe582ff24a7a4a9e85deb76bdd497f14,2025-05-23,Adult memory score look now.,4253.76,Credit,53583.05,,system,2025-06-08 17:17:13.603454,system,2025-06-08 17:17:13.603454
13721c18368e4ef1ab6cbf0d31663f7b,fe582ff24a7a4a9e85deb76bdd497f14,2025-03-15,Beat such movement environment strategy.,-782.9,Debit,52800.15,,system,2025-06-08 17:17:13.603454,system,2025-06-08 17:17:13.604439
c6785cfdadc4476094eb5bd00ce9ba99,3e8e250d45594da6b8e0140cc9a52840,2025-03-11,White short together add.,590.95,Credit,50590.95,,system,2025-06-08 17:17:13.604439,system,2025-06-08 17:17:13.604439
2767fc94bc1c4fdc993083767ba881d0,3e8e250d45594da6b8e0140cc9a52840,2025-05-30,Process push pressure determine rather adult should anyone.,-3900.61,Debit,46690.34,,system,2025-06-08 17:17:13.605001,system,2025-06-08 17:17:13.605001
9ffbd28f900449c7b98fa29f2a1e706f,3e8e250d45594da6b8e0140cc9a52840,2024-12-14,Make option anyone.,1765.84,Credit,48456.18,,system,2025-06-08 17:17:13.605001,system,2025-06-08 17:17:13.605001
d20be1935544404f9946154313c0c069,3e8e250d45594da6b8e0140cc9a52840,2025-06-07,Spend matter less.,1972.02,Credit,50428.2,,system,2025-06-08 17:17:13.605001,system,2025-06-08 17:17:13.605001
bedad05e305c40c0bd8275bf1816cf24,3e8e250d45594da6b8e0140cc9a52840,2025-03-13,Outside Republican world leader both hope.,-2001.03,Debit,48427.17,,system,2025-06-08 17:17:13.605001,system,2025-06-08 17:17:13.605001
389346ca14e24ab9a426558428ca672c,3e8e250d45594da6b8e0140cc9a52840,2025-04-22,Wind TV top until authority.,-4768.4,Debit,43658.77,,system,2025-06-08 17:17:13.605001,system,2025-06-08 17:17:13.605001
08cd5374aa8d4d55b16fd15dfe904967,3e8e250d45594da6b8e0140cc9a52840,2025-05-15,Four dark century before focus.,4594.21,Credit,48252.98,,system,2025-06-08 17:17:13.605001,system,2025-06-08 17:17:13.605001
9de5f1d2d73f4b5ab6ef0e7a73680189,3e8e250d45594da6b8e0140cc9a52840,2025-03-13,Production really visit five.,-1883.48,Debit,46369.5,,system,2025-06-08 17:17:13.605001,system,2025-06-08 17:17:13.605001
8d1d66b471c14a939babc2ae6474ecf1,3e8e250d45594da6b8e0140cc9a52840,2025-05-23,Least our smile.,-2730.24,Debit,43639.26,,system,2025-06-08 17:17:13.605001,system,2025-06-08 17:17:13.605001
9bdac7b7f2064128bc89d7923a39421f,3e8e250d45594da6b8e0140cc9a52840,2025-02-10,Here school ok bad.,-3607.31,Debit,40031.95,,system,2025-06-08 17:17:13.605001,system,2025-06-08 17:17:13.605001
c99f857f17af4fb69c9a534925ac631f,11d46d952cd447f999404186310bc1a2,2024-12-15,Finish manager manage option great.,966.25,Credit,50966.25,,system,2025-06-08 17:17:13.605523,system,2025-06-08 17:17:13.605523
d7e062cd9eea436ea99ff4de1d120ab7,11d46d952cd447f999404186310bc1a2,2024-12-15,Hope can candidate financial.,1866.65,Credit,52832.9,,system,2025-06-08 17:17:13.605523,system,2025-06-08 17:17:13.605523
ff17f839ed344b6d81f1817d3817663f,11d46d952cd447f999404186310bc1a2,2025-04-12,Company ready threat although.,-2674.6,Debit,50158.3,,system,2025-06-08 17:17:13.605523,system,2025-06-08 17:17:13.605523
d9eed4cafb534c279ed3b4d327032c61,11d46d952cd447f999404186310bc1a2,2025-01-01,Direction friend better measure.,2505.97,Credit,52664.27,,system,2025-06-08 17:17:13.605523,system,2025-06-08 17:17:13.605523
0cf25a8eada34af7b9cd65712191ed10,11d46d952cd447f999404186310bc1a2,2025-03-16,Scene smile walk paper miss.,3584.72,Credit,56248.99,,system,2025-06-08 17:17:13.605523,system,2025-06-08 17:17:13.605523
9aac56fa9e324288be879ebe5373772b,11d46d952cd447f999404186310bc1a2,2025-05-14,Style yourself return director.,-3119.09,Debit,53129.9,,system,2025-06-08 17:17:13.605523,system,2025-06-08 17:17:13.605523
6a4624a38de94b3da6eec2acd45caeb0,11d46d952cd447f999404186310bc1a2,2025-04-08,Tree television scene everybody hard rather book.,-3883.25,Debit,49246.65,,system,2025-06-08 17:17:13.605523,system,2025-06-08 17:17:13.605523
2ef6a859171a4c89aa68fc66bd00c91d,11d46d952cd447f999404186310bc1a2,2025-01-12,Walk court real throughout.,1568.2,Credit,50814.85,,system,2025-06-08 17:17:13.605523,system,2025-06-08 17:17:13.605523
0068952623c2434b931a57fec9726223,11d46d952cd447f999404186310bc1a2,2025-04-27,Week season behavior create black.,-4708.08,Debit,46106.77,,system,2025-06-08 17:17:13.605523,system,2025-06-08 17:17:13.605523
8807838829da4e6683a010f1fda17696,11d46d952cd447f999404186310bc1a2,2025-04-22,Bill carry sense main around.,-988.95,Debit,45117.82,,system,2025-06-08 17:17:13.605523,system,2025-06-08 17:17:13.605523
f8bca8b25b8843c38766bebf1ac07bc6,48dbc20e79174a42940c5d9b4e761613,2025-04-02,Politics few grow foreign describe there remain.,3849.19,Credit,53849.19,,system,2025-06-08 17:17:13.605523,system,2025-06-08 17:17:13.605523
e30c150d1d9a4ab49359886a79cfccbc,48dbc20e79174a42940c5d9b4e761613,2025-02-17,Local rule answer allow admit left camera assume.,-3510.13,Debit,50339.06,,system,2025-06-08 17:17:13.605523,system,2025-06-08 17:17:13.605523
e867aa77209c4d3eafc62d9419584592,48dbc20e79174a42940c5d9b4e761613,2025-03-03,Blood sense lay half property owner with.,3404.93,Credit,53743.99,,system,2025-06-08 17:17:13.605523,system,2025-06-08 17:17:13.605523
d3058d8212c543438ea5e72c93698382,48dbc20e79174a42940c5d9b4e761613,2024-12-20,Exist among product policy.,4061.11,Credit,57805.1,,system,2025-06-08 17:17:13.605523,system,2025-06-08 17:17:13.605523
744821a35f8647e182d2a338a886d315,48dbc20e79174a42940c5d9b4e761613,2024-12-13,Brother enjoy require will specific.,-1560.54,Debit,56244.56,,system,2025-06-08 17:17:13.605523,system,2025-06-08 17:17:13.605523
3ff79636a4e840d086c0d5a81bbd3caf,48dbc20e79174a42940c5d9b4e761613,2025-03-07,Admit concern avoid number they share than.,-4488.87,Debit,51755.69,,system,2025-06-08 17:17:13.605523,system,2025-06-08 17:17:13.605523
f40b5ebed7624f4aba8dd3f3392f6f89,48dbc20e79174a42940c5d9b4e761613,2025-01-24,International husband pattern.,-40.9,Debit,51714.79,,system,2025-06-08 17:17:13.605523,system,2025-06-08 17:17:13.605523
db8cf1dff927499f9deb1dfcb4150f3b,48dbc20e79174a42940c5d9b4e761613,2024-12-17,Cut real TV available save shake television.,-3075.61,Debit,48639.18,,system,2025-06-08 17:17:13.605523,system,2025-06-08 17:17:13.605523
f7240203adce49c69b915f36e25d22f4,48dbc20e79174a42940c5d9b4e761613,2025-03-26,Two Mr south some position example.,-1499.03,Debit,47140.15,,system,2025-06-08 17:17:13.605523,system,2025-06-08 17:17:13.605523
349ea07722fa4457aa2c76a5fd2d1475,48dbc20e79174a42940c5d9b4e761613,2025-05-19,Several kind Democrat every area deal throughout.,-1577.78,Debit,45562.37,,system,2025-06-08 17:17:13.605523,system,2025-06-08 17:17:13.605523
d9165a98cc204439aeb0b4f77115ed8d,dc530dfcaf424563b78aa99a84d25490,2025-02-18,Course around air back opportunity else always religious.,-2404.56,Debit,47595.44,,system,2025-06-08 17:17:13.605523,system,2025-06-08 17:17:13.605523
5cbe3489d7b94b6ab9f2473b07598856,dc530dfcaf424563b78aa99a84d25490,2025-01-05,Certainly minute member billion.,4767.99,Credit,52363.43,,system,2025-06-08 17:17:13.605523,system,2025-06-08 17:17:13.605523
0e9abbf256dc45bca5bae68d5197c091,dc530dfcaf424563b78aa99a84d25490,2024-12-30,His we factor age.,3237.97,Credit,55601.4,,system,2025-06-08 17:17:13.605523,system,2025-06-08 17:17:13.605523
41c532648d9e4806996fc8c6a3f4474b,dc530dfcaf424563b78aa99a84d25490,2025-04-10,Experience campaign above.,-4191.78,Debit,51409.62,,system,2025-06-08 17:17:13.605523,system,2025-06-08 17:17:13.605523
be959b8216ab4b5696e1de566a017910,dc530dfcaf424563b78aa99a84d25490,2025-05-19,Thing always phone food interesting.,-1758.21,Debit,49651.41,,system,2025-06-08 17:17:13.605523,system,2025-06-08 17:17:13.605523
8b8b9ab840be447e80bf4b2d4905c158,dc530dfcaf424563b78aa99a84d25490,2025-03-23,Pass plan design identify couple may.,-233.64,Debit,49417.77,,system,2025-06-08 17:17:13.605523,system,2025-06-08 17:17:13.605523
72f6b6ec151940dea07789ec03e64a2d,dc530dfcaf424563b78aa99a84d25490,2025-03-09,Me season president about strong party.,-1559.8,Debit,47857.97,,system,2025-06-08 17:17:13.605523,system,2025-06-08 17:17:13.605523
2c7a5c664f0b4729af8d630a279590e6,dc530dfcaf424563b78aa99a84d25490,2024-12-15,Both strong mean sense grow voice.,-1873.36,Debit,45984.61,,system,2025-06-08 17:17:13.605523,system,2025-06-08 17:17:13.605523
192e97fd662e414eba8fe7234aab96f4,dc530dfcaf424563b78aa99a84d25490,2025-02-12,Kitchen case mission meeting.,-2800.8,Debit,43183.81,,system,2025-06-08 17:17:13.605523,system,2025-06-08 17:17:13.605523
b3048e81acdd4d7cb4be1c6ee494d91d,dc530dfcaf424563b78aa99a84d25490,2025-02-22,Mouth nearly PM.,1985.38,Credit,45169.19,,system,2025-06-08 17:17:13.605523,system,2025-06-08 17:17:13.605523
9a81812109f04dbe929a9ee140e31b8d,236ea2aa1e1a4d4488636f0d774c3bfa,2025-04-22,Enjoy together military scene.,-3642.88,Debit,46357.12,,system,2025-06-08 17:17:13.605523,system,2025-06-08 17:17:13.605523
2e1b6066235f4a059ca8194e6db55391,236ea2aa1e1a4d4488636f0d774c3bfa,2025-05-12,Kid away thousand suddenly ahead maybe step daughter.,438.16,Credit,46795.28,,system,2025-06-08 17:17:13.605523,system,2025-06-08 17:17:13.605523
8934015536e142cea063cff93c786af5,236ea2aa1e1a4d4488636f0d774c3bfa,2025-04-18,Remember majority offer purpose.,-842.67,Debit,45952.61,,system,2025-06-08 17:17:13.605523,system,2025-06-08 17:17:13.605523
6e29e51cc2c243e79986c46486591e65,236ea2aa1e1a4d4488636f0d774c3bfa,2025-04-05,Wait natural option enter player skill.,-2525.49,Debit,43427.12,,system,2025-06-08 17:17:13.605523,system,2025-06-08 17:17:13.605523
a6922f3840934e7b82c84a91fbf085b3,236ea2aa1e1a4d4488636f0d774c3bfa,2025-05-04,Activity capital easy finish.,-1147.29,Debit,42279.83,,system,2025-06-08 17:17:13.605523,system,2025-06-08 17:17:13.605523
f0ce15c653e64796aa16c0b90add38c4,236ea2aa1e1a4d4488636f0d774c3bfa,2024-12-20,But blue worry image sense trip.,3458.56,Credit,45738.39,,system,2025-06-08 17:17:13.605523,system,2025-06-08 17:17:13.605523
e0450b3aadf44c199dd5cf2fad5fd511,236ea2aa1e1a4d4488636f0d774c3bfa,2025-02-07,Follow could decision discover so stock.,-1825.39,Debit,43913.0,,system,2025-06-08 17:17:13.605523,system,2025-06-08 17:17:13.605523
3484bc686008456489760ca05d28311f,236ea2aa1e1a4d4488636f0d774c3bfa,2025-02-20,Thank him charge leg.,-1254.48,Debit,42658.52,,system,2025-06-08 17:17:13.605523,system,2025-06-08 17:17:13.605523
1e89324cb92749498b7ea5db4bff2e1f,236ea2aa1e1a4d4488636f0d774c3bfa,2025-04-27,Pressure media scientist choose wind country such.,2191.42,Credit,44849.94,,system,2025-06-08 17:17:13.605523,system,2025-06-08 17:17:13.605523
03cbea224a8a432eaf6e65663390daf4,236ea2aa1e1a4d4488636f0d774c3bfa,2025-04-04,Your energy head data eat.,2610.51,Credit,47460.45,,system,2025-06-08 17:17:13.605523,system,2025-06-08 17:17:13.605523
dcc6749763a84dafa2bce9e1d034f768,9f4f44c29fdf4fc4806b3e2e68a5ff76,2025-04-25,No force time year.,3829.7,Credit,53829.7,,system,2025-06-08 17:17:13.605523,system,2025-06-08 17:17:13.605523
1a9ba334e17043c99a5d9381ebbe0180,9f4f44c29fdf4fc4806b3e2e68a5ff76,2025-06-01,Hot night author operation window.,2532.57,Credit,56362.27,,system,2025-06-08 17:17:13.605523,system,2025-06-08 17:17:13.605523
27bbeaf2b48e4fe487691c097327b6d0,9f4f44c29fdf4fc4806b3e2e68a5ff76,2025-01-25,Three than property enjoy large.,136.95,Credit,56499.22,,system,2025-06-08 17:17:13.605523,system,2025-06-08 17:17:13.605523
d0b0e11cd15149c6a498131c7cd08629,9f4f44c29fdf4fc4806b3e2e68a5ff76,2024-12-23,House decade moment sing.,-3814.72,Debit,52684.5,,system,2025-06-08 17:17:13.605523,system,2025-06-08 17:17:13.605523
729982c7370449ffbe1ab33fb4382fe0,9f4f44c29fdf4fc4806b3e2e68a5ff76,2025-04-29,Yet staff face.,-579.25,Debit,52105.25,,system,2025-06-08 17:17:13.605523,system,2025-06-08 17:17:13.605523
59388063f41b462fbf26a35693950f56,9f4f44c29fdf4fc4806b3e2e68a5ff76,2024-12-31,Low open debate something bill yes.,-4858.84,Debit,47246.41,,system,2025-06-08 17:17:13.605523,system,2025-06-08 17:17:13.605523
1c80a32d7a38496899ce1700b8e020a2,9f4f44c29fdf4fc4806b3e2e68a5ff76,2025-02-20,Evidence consumer make quite car.,4329.09,Credit,51575.5,,system,2025-06-08 17:17:13.605523,system,2025-06-08 17:17:13.605523
6ea7ac7125a748babb7fa0e169a0434a,9f4f44c29fdf4fc4806b3e2e68a5ff76,2025-05-18,Real both type play live.,710.2,Credit,52285.7,,system,2025-06-08 17:17:13.605523,system,2025-06-08 17:17:13.605523
8a38e006a9c645b0a1a12caeac3d0316,9f4f44c29fdf4fc4806b3e2e68a5ff76,2025-02-18,Admit season indicate democratic.,1035.07,Credit,53320.77,,system,2025-06-08 17:17:13.605523,system,2025-06-08 17:17:13.605523
43ad4e05bb944712a8fc334a3558474f,9f4f44c29fdf4fc4806b3e2e68a5ff76,2025-04-09,List outside test free story.,-2595.01,Debit,50725.76,,system,2025-06-08 17:17:13.605523,system,2025-06-08 17:17:13.605523
efa3bfe1f6ef4ec495ec0232268a7187,b96d6dd4686448819e0493f54b1f2b80,2025-01-06,Change class catch develop mother employee goal.,4229.47,Credit,54229.47,,system,2025-06-08 17:17:13.605523,system,2025-06-08 17:17:13.605523
dcd35a158c4b4c2f98c66edb74748d22,b96d6dd4686448819e0493f54b1f2b80,2025-05-21,Management subject learn avoid themselves woman simple.,-1639.73,Debit,52589.74,,system,2025-06-08 17:17:13.605523,system,2025-06-08 17:17:13.605523
5253eb8a74f145dbb82e2258c32de964,b96d6dd4686448819e0493f54b1f2b80,2025-02-02,Just those hospital event news ability environment.,-641.73,Debit,51948.01,,system,2025-06-08 17:17:13.605523,system,2025-06-08 17:17:13.605523
c81521c6372e4bb89ae6ca12d6bb987f,b96d6dd4686448819e0493f54b1f2b80,2025-03-21,If strong wall whatever century meeting opportunity foreign.,4410.25,Credit,56358.26,,system,2025-06-08 17:17:13.605523,system,2025-06-08 17:17:13.605523
761e993177dd40c4ad2686c82320da18,b96d6dd4686448819e0493f54b1f2b80,2025-03-16,Down foot mother.,-1644.13,Debit,54714.13,,system,2025-06-08 17:17:13.605523,system,2025-06-08 17:17:13.605523
23a3ac2368164f46a7ef5e7691ab745d,b96d6dd4686448819e0493f54b1f2b80,2025-01-08,Scientist study art alone population.,2211.04,Credit,56925.17,,system,2025-06-08 17:17:13.605523,system,2025-06-08 17:17:13.605523
c955eaef7bc64c4491faf0a0d8c5326b,b96d6dd4686448819e0493f54b1f2b80,2025-05-07,Environment today follow story sell model across really.,398.53,Credit,57323.7,,system,2025-06-08 17:17:13.605523,system,2025-06-08 17:17:13.605523
00757371965740ee97514a9edc6cb164,b96d6dd4686448819e0493f54b1f2b80,2024-12-10,Picture bring sign theory glass.,4143.8,Credit,61467.5,,system,2025-06-08 17:17:13.605523,system,2025-06-08 17:17:13.605523
89d3dd27c2ca48388a8ca694482703aa,b96d6dd4686448819e0493f54b1f2b80,2025-02-16,Lay debate skin country save back.,2235.75,Credit,63703.25,,system,2025-06-08 17:17:13.605523,system,2025-06-08 17:17:13.605523
53ca9c29c0454db5a4787f969199d50f,b96d6dd4686448819e0493f54b1f2b80,2025-05-14,Test husband power.,-2724.36,Debit,60978.89,,system,2025-06-08 17:17:13.605523,system,2025-06-08 17:17:13.605523
0c03264172d346af87319302eaf06b74,1611c362492f4771b2b08707ccb5a275,2025-04-14,Up what foreign among.,4476.43,Credit,54476.43,,system,2025-06-08 17:17:13.605523,system,2025-06-08 17:17:13.605523
94e3c0b359a3460db2e699f8a3270041,1611c362492f4771b2b08707ccb5a275,2025-04-11,Letter where material vote use theory.,-2196.03,Debit,52280.4,,system,2025-06-08 17:17:13.605523,system,2025-06-08 17:17:13.605523
9a8978d1aec64a9d91fba2691694a961,1611c362492f4771b2b08707ccb5a275,2025-01-24,Especially nothing sit it billion.,3277.85,Credit,55558.25,,system,2025-06-08 17:17:13.605523,system,2025-06-08 17:17:13.605523
692f5fec5e5646e4b468b0eef7df24d6,1611c362492f4771b2b08707ccb5a275,2025-01-24,None address still window no when tree.,4197.58,Credit,59755.83,,system,2025-06-08 17:17:13.605523,system,2025-06-08 17:17:13.605523
155d0b8463f346ea8a09b8e6a40783e0,1611c362492f4771b2b08707ccb5a275,2025-03-22,Important center realize eight.,4572.7,Credit,64328.53,,system,2025-06-08 17:17:13.605523,system,2025-06-08 17:17:13.605523
f9adb36a783048e2956fa3d3426888fc,1611c362492f4771b2b08707ccb5a275,2025-05-16,Enter response certainly position report.,20.82,Credit,64349.35,,system,2025-06-08 17:17:13.605523,system,2025-06-08 17:17:13.605523
8307bade11324c4c891bd43e8328df45,1611c362492f4771b2b08707ccb5a275,2024-12-24,Return professional show subject scene serve.,1575.71,Credit,65925.06,,system,2025-06-08 17:17:13.605523,system,2025-06-08 17:17:13.605523
d96edaff722648499b6beaf339b544ab,1611c362492f4771b2b08707ccb5a275,2025-05-02,Pattern return successful necessary financial down so education.,-3477.46,Debit,62447.6,,system,2025-06-08 17:17:13.605523,system,2025-06-08 17:17:13.605523
ff43204c6ef2406991eddfa5d0617ec8,1611c362492f4771b2b08707ccb5a275,2025-04-07,Girl trip room risk challenge.,-1307.03,Debit,61140.57,,system,2025-06-08 17:17:13.605523,system,2025-06-08 17:17:13.605523
e624fbcd9dc149b5b6ca562a2106073b,1611c362492f4771b2b08707ccb5a275,2025-03-07,Great lose else environmental or.,-992.62,Debit,60147.95,,system,2025-06-08 17:17:13.605523,system,2025-06-08 17:17:13.605523
aa70fcd41aae4bfaa3e403c5ce78608a,abeb147745544f6398aa06dbe9316f89,2024-12-17,Program a bed instead seek similar.,-4538.02,Debit,45461.98,,system,2025-06-08 17:17:13.605523,system,2025-06-08 17:17:13.605523
408c8e97d17e47b6acf415ce70629c4c,abeb147745544f6398aa06dbe9316f89,2025-04-25,Trade born about.,-3552.47,Debit,41909.51,,system,2025-06-08 17:17:13.605523,system,2025-06-08 17:17:13.605523
3018e516b4a84466be971ff0880432d0,abeb147745544f6398aa06dbe9316f89,2025-04-09,Accept new section drug several.,2854.33,Credit,44763.84,,system,2025-06-08 17:17:13.605523,system,2025-06-08 17:17:13.605523
6ce7405ce60b41a29a52ee87db05a07e,abeb147745544f6398aa06dbe9316f89,2025-04-04,Doctor and catch here southern reflect radio child.,-3929.33,Debit,40834.51,,system,2025-06-08 17:17:13.605523,system,2025-06-08 17:17:13.605523
feb22e2a75c44c619f6ae38c6106a152,abeb147745544f6398aa06dbe9316f89,2025-03-08,Believe even buy way option realize huge you.,-3674.85,Debit,37159.66,,system,2025-06-08 17:17:13.605523,system,2025-06-08 17:17:13.605523
fed142282c3540579b7d487e77d61491,abeb147745544f6398aa06dbe9316f89,2025-02-15,Mr keep stock tonight.,2671.09,Credit,39830.75,,system,2025-06-08 17:17:13.605523,system,2025-06-08 17:17:13.605523
24f4fda8373442ee9cc8b3f673420cf8,abeb147745544f6398aa06dbe9316f89,2025-04-22,Option man dinner religious picture.,-1214.03,Debit,38616.72,,system,2025-06-08 17:17:13.605523,system,2025-06-08 17:17:13.605523
df7e394f4b814139a38eac98ed1872b7,abeb147745544f6398aa06dbe9316f89,2025-05-23,Mean read dinner itself.,1063.79,Credit,39680.51,,system,2025-06-08 17:17:13.605523,system,2025-06-08 17:17:13.605523
8c3f3ed041fd47d3a34526f0a835c82b,abeb147745544f6398aa06dbe9316f89,2025-03-16,Produce media rock.,-3898.01,Debit,35782.5,,system,2025-06-08 17:17:13.605523,system,2025-06-08 17:17:13.605523
1849913560334fd1a11e75c571b6ad8a,abeb147745544f6398aa06dbe9316f89,2025-06-02,Because stuff service treatment own subject section detail.,-2071.95,Debit,33710.55,,system,2025-06-08 17:17:13.605523,system,2025-06-08 17:17:13.605523
25fc356955a24c7c9b1b3c03692665b7,2f7212a2226e462cb477bf546ffb7d8f,2024-12-30,History base prevent staff adult ability every.,2484.87,Credit,52484.87,,system,2025-06-08 17:17:13.605523,system,2025-06-08 17:17:13.605523
cc9b1e4b0cd14c2c8c1d8be97e3305d6,2f7212a2226e462cb477bf546ffb7d8f,2025-05-18,Middle friend decision because nation record room.,-2412.39,Debit,50072.48,,system,2025-06-08 17:17:13.605523,system,2025-06-08 17:17:13.605523
87d431bb73414b8d926ebb0e23347eba,2f7212a2226e462cb477bf546ffb7d8f,2025-04-18,Great budget as.,213.37,Credit,50285.85,,system,2025-06-08 17:17:13.605523,system,2025-06-08 17:17:13.605523
4375efd1f1934ae4860275fae65633a9,2f7212a2226e462cb477bf546ffb7d8f,2025-04-06,Something public nearly partner.,1468.97,Credit,51754.82,,system,2025-06-08 17:17:13.605523,system,2025-06-08 17:17:13.605523
3663a18983a14a949f2ac43754d2b6a3,2f7212a2226e462cb477bf546ffb7d8f,2025-01-02,Central its strong.,-641.21,Debit,51113.61,,system,2025-06-08 17:17:13.605523,system,2025-06-08 17:17:13.605523
69ec4c178f094f9b81433efdb035016c,2f7212a2226e462cb477bf546ffb7d8f,2025-05-18,Person he discuss rock.,-1274.88,Debit,49838.73,,system,2025-06-08 17:17:13.605523,system,2025-06-08 17:17:13.605523
76f09c3e694a4675a3c5e5b99d7fce40,2f7212a2226e462cb477bf546ffb7d8f,2024-12-15,Wall establish research brother.,3865.99,Credit,53704.72,,system,2025-06-08 17:17:13.605523,system,2025-06-08 17:17:13.605523
93e301f548134513a2cc2840cbb3a3a9,2f7212a2226e462cb477bf546ffb7d8f,2025-04-29,Store social six decide half have perhaps.,1531.74,Credit,55236.46,,system,2025-06-08 17:17:13.605523,system,2025-06-08 17:17:13.605523
9ade585d5dfb4516ab95b699d77983ee,2f7212a2226e462cb477bf546ffb7d8f,2025-01-10,Minute hold alone community manage.,1644.72,Credit,56881.18,,system,2025-06-08 17:17:13.605523,system,2025-06-08 17:17:13.605523
175000d6242b4ca7af0579485456569c,2f7212a2226e462cb477bf546ffb7d8f,2025-05-09,Camera trouble look fly their institution.,-161.91,Debit,56719.27,,system,2025-06-08 17:17:13.605523,system,2025-06-08 17:17:13.605523
dc3eb91a8c684df48e5170e966bf6002,f91866b5f43347ecb5ff41b70949ade1,2025-05-12,Sign buy do black large suddenly different.,1782.04,Credit,51782.04,,system,2025-06-08 17:17:13.605523,system,2025-06-08 17:17:13.605523
428d9599ebb24ae384a53b5c6a15ee53,f91866b5f43347ecb5ff41b70949ade1,2025-02-24,Night peace artist first that activity class.,-1793.07,Debit,49988.97,,system,2025-06-08 17:17:13.605523,system,2025-06-08 17:17:13.605523
3d3d3713709f413a909b11bfff5a6064,f91866b5f43347ecb5ff41b70949ade1,2025-01-10,Size dream watch policy area space bring effort.,-3529.23,Debit,46459.74,,system,2025-06-08 17:17:13.605523,system,2025-06-08 17:17:13.605523
ffa04e353bc1453aa992a8c5de9cd5aa,f91866b5f43347ecb5ff41b70949ade1,2024-12-18,Policy reality store receive.,-3853.08,Debit,42606.66,,system,2025-06-08 17:17:13.605523,system,2025-06-08 17:17:13.605523
dbe5dbdcc4524fbe80b38450504399b5,f91866b5f43347ecb5ff41b70949ade1,2025-01-05,Citizen environmental final activity him help attention.,4361.28,Credit,46967.94,,system,2025-06-08 17:17:13.605523,system,2025-06-08 17:17:13.605523
160cdad637d24e1c86b7166a1dee6d17,f91866b5f43347ecb5ff41b70949ade1,2025-03-14,Tree action rise step onto property task.,-3734.93,Debit,43233.01,,system,2025-06-08 17:17:13.605523,system,2025-06-08 17:17:13.605523
435ab209ef2f414b836cac8bee08a03c,f91866b5f43347ecb5ff41b70949ade1,2025-02-13,Campaign official usually family often management relationship.,3088.98,Credit,46321.99,,system,2025-06-08 17:17:13.605523,system,2025-06-08 17:17:13.605523
495bbcada9a34534a8f217f71f129dc4,f91866b5f43347ecb5ff41b70949ade1,2025-04-28,Agency room bit shake.,-2863.71,Debit,43458.28,,system,2025-06-08 17:17:13.605523,system,2025-06-08 17:17:13.605523
1661614df8414f3e8e95d6b2c51cd5b7,f91866b5f43347ecb5ff41b70949ade1,2025-02-19,Price decade leg system evidence hospital nature manager.,92.34,Credit,43550.62,,system,2025-06-08 17:17:13.605523,system,2025-06-08 17:17:13.605523
ee3448852bd340d9ae29aa589229b63b,f91866b5f43347ecb5ff41b70949ade1,2025-01-02,Positive them must memory seat.,-3587.45,Debit,39963.17,,system,2025-06-08 17:17:13.605523,system,2025-06-08 17:17:13.605523
b4b8601f85804a8ebff19b8d4b283aa9,34064e9be7704f7b8e7fab96ae773073,2025-05-26,Represent side mouth case.,-4166.19,Debit,45833.81,,system,2025-06-08 17:17:13.605523,system,2025-06-08 17:17:13.605523
3e977dd9e6e54075850b500b0f616a97,34064e9be7704f7b8e7fab96ae773073,2025-02-03,Not international never stand.,2311.54,Credit,48145.35,,system,2025-06-08 17:17:13.605523,system,2025-06-08 17:17:13.605523
bd7d6a3214344c75be5bc708ab23c5e7,34064e9be7704f7b8e7fab96ae773073,2025-01-01,Maintain experience toward card scene return dark huge.,-2714.12,Debit,45431.23,,system,2025-06-08 17:17:13.605523,system,2025-06-08 17:17:13.605523
dab943ea9cb54474b2f73cd5631eb057,34064e9be7704f7b8e7fab96ae773073,2025-05-14,Half population move far reveal picture federal.,-3443.8,Debit,41987.43,,system,2025-06-08 17:17:13.605523,system,2025-06-08 17:17:13.605523
1721a70513d54fdb96382418fb4debea,34064e9be7704f7b8e7fab96ae773073,2025-04-06,Either enough establish seek minute.,937.04,Credit,42924.47,,system,2025-06-08 17:17:13.605523,system,2025-06-08 17:17:13.605523
2dc4116c4fc4405eb925b080dc00a80d,34064e9be7704f7b8e7fab96ae773073,2025-05-20,Dream expert at campaign stage.,-1029.3,Debit,41895.17,,system,2025-06-08 17:17:13.605523,system,2025-06-08 17:17:13.605523
613ec6373e384782a4dfd956914c39be,34064e9be7704f7b8e7fab96ae773073,2025-02-15,Eat get seat.,2868.46,Credit,44763.63,,system,2025-06-08 17:17:13.605523,system,2025-06-08 17:17:13.605523
cd39a718bb1447e4af602e009eb43215,34064e9be7704f7b8e7fab96ae773073,2025-02-11,Quickly stand go ok conference.,-2821.69,Debit,41941.94,,system,2025-06-08 17:17:13.605523,system,2025-06-08 17:17:13.605523
aee63b3f114845c18dbad36d4c0204e5,34064e9be7704f7b8e7fab96ae773073,2025-02-05,Movement organization during six full economy read.,-648.51,Debit,41293.43,,system,2025-06-08 17:17:13.605523,system,2025-06-08 17:17:13.605523
27c3d389939b4fe0b61f9d534b9d7e0b,34064e9be7704f7b8e7fab96ae773073,2025-06-02,Behind effort police public strong assume woman.,-3860.92,Debit,37432.51,,system,2025-06-08 17:17:13.605523,system,2025-06-08 17:17:13.605523
cd4e4133510948fd95471ed7401d4365,1a21c79209c5405a8b8511ab4726c36a,2025-01-15,Benefit local simple choice.,-1410.15,Debit,48589.85,,system,2025-06-08 17:17:13.605523,system,2025-06-08 17:17:13.605523
00ef4868b7d0421eaaec51c2cf680f68,1a21c79209c5405a8b8511ab4726c36a,2025-02-13,Teacher many easy land turn born.,138.45,Credit,48728.3,,system,2025-06-08 17:17:13.605523,system,2025-06-08 17:17:13.605523
00d4809b1b7f4cbd82d7b60dcb813c08,1a21c79209c5405a8b8511ab4726c36a,2025-02-15,Him himself article who rest.,-126.76,Debit,48601.54,,system,2025-06-08 17:17:13.605523,system,2025-06-08 17:17:13.605523
b5bec2a8a6e943c9a1642f22f044adc4,1a21c79209c5405a8b8511ab4726c36a,2025-03-12,Nation ask respond work up why talk clear.,1434.69,Credit,50036.23,,system,2025-06-08 17:17:13.605523,system,2025-06-08 17:17:13.605523
21733359877a428f9bcc8d4fefaad016,1a21c79209c5405a8b8511ab4726c36a,2025-01-01,Learn suddenly success grow yard thank.,3504.43,Credit,53540.66,,system,2025-06-08 17:17:13.605523,system,2025-06-08 17:17:13.605523
79d4a35488ae443596f34467c3a69596,1a21c79209c5405a8b8511ab4726c36a,2025-05-19,Although by range pressure personal.,3404.88,Credit,56945.54,,system,2025-06-08 17:17:13.605523,system,2025-06-08 17:17:13.605523
0c3e48df812e443b99020f81cfb6b99b,1a21c79209c5405a8b8511ab4726c36a,2025-04-19,Trouble exactly with half.,-1268.4,Debit,55677.14,,system,2025-06-08 17:17:13.605523,system,2025-06-08 17:17:13.605523
b5bde843d1f9466481a8e866485d680f,1a21c79209c5405a8b8511ab4726c36a,2025-03-30,Lose financial Congress.,-4435.2,Debit,51241.94,,system,2025-06-08 17:17:13.605523,system,2025-06-08 17:17:13.605523
be0a87257fb949129e82489e42e5291b,1a21c79209c5405a8b8511ab4726c36a,2025-06-06,News hot weight help conference.,-1822.04,Debit,49419.9,,system,2025-06-08 17:17:13.605523,system,2025-06-08 17:17:13.605523
fad2c1d3763548bbb985faab906c14f9,1a21c79209c5405a8b8511ab4726c36a,2025-04-24,Tough drop out maintain behavior.,3088.65,Credit,52508.55,,system,2025-06-08 17:17:13.605523,system,2025-06-08 17:17:13.605523
7de4138199a74ae3b8ff06b61f1eb9fe,fa84cb75823d4aa1b86a81ecd01d219a,2024-12-25,Example high until strategy phone source.,-4941.22,Debit,45058.78,,system,2025-06-08 17:17:13.605523,system,2025-06-08 17:17:13.605523
52867972cf224c25998f8ea47dd0b6a4,fa84cb75823d4aa1b86a81ecd01d219a,2025-01-26,Skill plan cultural help world.,-1227.16,Debit,43831.62,,system,2025-06-08 17:17:13.605523,system,2025-06-08 17:17:13.605523
10dfeb83276a46ed9ed1463542abfb67,fa84cb75823d4aa1b86a81ecd01d219a,2025-02-02,Hospital training director education thing member.,-2559.64,Debit,41271.98,,system,2025-06-08 17:17:13.605523,system,2025-06-08 17:17:13.605523
9c6f20ba579f410285720c78b41e418e,fa84cb75823d4aa1b86a81ecd01d219a,2025-05-31,Candidate laugh person your under share just.,549.52,Credit,41821.5,,system,2025-06-08 17:17:13.605523,system,2025-06-08 17:17:13.605523
dc29de1918af4e908a35eaa9d47db7c2,fa84cb75823d4aa1b86a81ecd01d219a,2025-03-21,Wear network senior ten page pretty.,3870.54,Credit,45692.04,,system,2025-06-08 17:17:13.605523,system,2025-06-08 17:17:13.605523
7c0637e5140b437a9401e941a4a52972,fa84cb75823d4aa1b86a81ecd01d219a,2025-05-25,Glass actually everything medical movement relationship perform.,1379.51,Credit,47071.55,,system,2025-06-08 17:17:13.605523,system,2025-06-08 17:17:13.605523
56deefaff12e43c8ace9efdf79ec4780,fa84cb75823d4aa1b86a81ecd01d219a,2025-03-20,Available four each example score chair include.,-3298.99,Debit,43772.56,,system,2025-06-08 17:17:13.605523,system,2025-06-08 17:17:13.605523
db2c4f69d02e49528c2f772cd875794b,fa84cb75823d4aa1b86a81ecd01d219a,2025-02-13,Every young eye maintain walk civil.,29.99,Credit,43802.55,,system,2025-06-08 17:17:13.605523,system,2025-06-08 17:17:13.605523
881bbe97eefe4e8bab375045c5f63fea,fa84cb75823d4aa1b86a81ecd01d219a,2025-05-27,Room feeling couple newspaper minute message trip.,2612.32,Credit,46414.87,,system,2025-06-08 17:17:13.605523,system,2025-06-08 17:17:13.605523
5e512e76c0284c1c81e2e3f60daa7a8a,fa84cb75823d4aa1b86a81ecd01d219a,2025-05-27,Such man study lay to blue.,-2622.6,Debit,43792.27,,system,2025-06-08 17:17:13.605523,system,2025-06-08 17:17:13.605523
d78f9cd701374049b0e492a2e8c8af3d,5df28d58b0784807b53310229806927a,2025-01-05,Mind woman finally learn friend society.,-2277.99,Debit,47722.01,,system,2025-06-08 17:17:13.605523,system,2025-06-08 17:17:13.605523
66851e9043be4509b31e2775becd6c80,5df28d58b0784807b53310229806927a,2025-04-17,War fine somebody.,2808.71,Credit,50530.72,,system,2025-06-08 17:17:13.605523,system,2025-06-08 17:17:13.605523
e174b0cf11b645fba80ff9c36f5e0a28,5df28d58b0784807b53310229806927a,2024-12-15,These set probably guess parent.,-2268.57,Debit,48262.15,,system,2025-06-08 17:17:13.605523,system,2025-06-08 17:17:13.605523
65f444dccc7445bd8c201153fb8f1051,5df28d58b0784807b53310229806927a,2024-12-17,Serve well feeling mean standard.,1897.74,Credit,50159.89,,system,2025-06-08 17:17:13.605523,system,2025-06-08 17:17:13.605523
e4572f37a5cb4e9f9a3be24aadbfb14c,5df28d58b0784807b53310229806927a,2024-12-30,Reveal work task possible student where keep.,-1520.14,Debit,48639.75,,system,2025-06-08 17:17:13.605523,system,2025-06-08 17:17:13.605523
921b3f6aa7064f22bbb2cdccd877ad23,5df28d58b0784807b53310229806927a,2025-05-02,Future example worker management skin certain.,-4311.93,Debit,44327.82,,system,2025-06-08 17:17:13.605523,system,2025-06-08 17:17:13.605523
390c64280cb24920a7b7584f834c3b5f,5df28d58b0784807b53310229806927a,2025-02-20,Per sense production wall.,-2599.06,Debit,41728.76,,system,2025-06-08 17:17:13.605523,system,2025-06-08 17:17:13.605523
d08f72dd843b44e2935cd08e5eb97abc,5df28d58b0784807b53310229806927a,2025-05-15,Main guy body American series.,417.04,Credit,42145.8,,system,2025-06-08 17:17:13.605523,system,2025-06-08 17:17:13.605523
e0b0cac20b5d4050b672f14d83943b21,5df28d58b0784807b53310229806927a,2025-04-07,Teach front Congress economy form.,-4553.46,Debit,37592.34,,system,2025-06-08 17:17:13.605523,system,2025-06-08 17:17:13.605523
68c61a8a7afc441da61977413051a4c8,5df28d58b0784807b53310229806927a,2024-12-20,Meeting safe even later.,3301.05,Credit,40893.39,,system,2025-06-08 17:17:13.605523,system,2025-06-08 17:17:13.605523
5749aea9272944b8be4ba599da964efe,e8f429ce365a402bac9ca6471dd82669,2025-04-25,Space especially act right.,-3678.38,Debit,46321.62,,system,2025-06-08 17:17:13.605523,system,2025-06-08 17:17:13.605523
83a630a3706e49ac99b4d79e9be1e5be,e8f429ce365a402bac9ca6471dd82669,2025-03-20,Fact hope miss experience always reveal become career.,-4283.29,Debit,42038.33,,system,2025-06-08 17:17:13.605523,system,2025-06-08 17:17:13.605523
a55c50ad3b7d49b6a1e151b0e8cc7733,e8f429ce365a402bac9ca6471dd82669,2025-04-07,Indicate action see surface dog debate when number.,-3998.71,Debit,38039.62,,system,2025-06-08 17:17:13.605523,system,2025-06-08 17:17:13.605523
1ba860856b2f42a4b8719d2fe85d24a2,e8f429ce365a402bac9ca6471dd82669,2025-05-24,Bring water fast recent product step.,-2191.83,Debit,35847.79,,system,2025-06-08 17:17:13.605523,system,2025-06-08 17:17:13.605523
5b93c50109df4bb49a262215b0b0dd7f,e8f429ce365a402bac9ca6471dd82669,2025-03-21,Teach commercial test.,-3994.5,Debit,31853.29,,system,2025-06-08 17:17:13.605523,system,2025-06-08 17:17:13.605523
ba220600cdd64c66a5c483ce99a9ac1a,e8f429ce365a402bac9ca6471dd82669,2025-06-08,Good street community film.,-3403.17,Debit,28450.12,,system,2025-06-08 17:17:13.605523,system,2025-06-08 17:17:13.605523
e975794bcaac4ad78e0d5111f84eac74,e8f429ce365a402bac9ca6471dd82669,2025-01-22,Represent natural hold drive.,-4014.6,Debit,24435.52,,system,2025-06-08 17:17:13.605523,system,2025-06-08 17:17:13.605523
11f6a2c26eb94cdda4187d8bb9000eda,e8f429ce365a402bac9ca6471dd82669,2025-04-26,Stage list mention throughout.,1575.34,Credit,26010.86,,system,2025-06-08 17:17:13.605523,system,2025-06-08 17:17:13.605523
6c9c6e8b366344d68a9654836247c170,e8f429ce365a402bac9ca6471dd82669,2025-04-09,Nor have agent others.,-1383.38,Debit,24627.48,,system,2025-06-08 17:17:13.605523,system,2025-06-08 17:17:13.605523
3c986cf3003b43548c085b61337b9363,e8f429ce365a402bac9ca6471dd82669,2025-01-19,Relationship include human should.,-3261.87,Debit,21365.61,,system,2025-06-08 17:17:13.605523,system,2025-06-08 17:17:13.605523
891f5ad1c28c400c91632b8fcd11477d,e717275b4e0242a99ce7561f3164a553,2024-12-15,Imagine page develop information hundred population idea.,2402.32,Credit,52402.32,,system,2025-06-08 17:17:13.605523,system,2025-06-08 17:17:13.605523
e95e41925e944ff88729318325309f85,e717275b4e0242a99ce7561f3164a553,2024-12-18,Picture who bar night need.,2312.04,Credit,54714.36,,system,2025-06-08 17:17:13.605523,system,2025-06-08 17:17:13.605523
f2ac0fd66b3348b597be2abce2e95e2e,e717275b4e0242a99ce7561f3164a553,2025-05-08,Positive style analysis material.,-1132.64,Debit,53581.72,,system,2025-06-08 17:17:13.605523,system,2025-06-08 17:17:13.605523
fcbf614616c34b9994ca64b8a45254d0,e717275b4e0242a99ce7561f3164a553,2024-12-27,Movement character may activity low play.,2236.65,Credit,55818.37,,system,2025-06-08 17:17:13.605523,system,2025-06-08 17:17:13.605523
6fc998fef1014c1580bc0d9bd26a0060,e717275b4e0242a99ce7561f3164a553,2025-02-22,Natural board have daughter imagine series.,-889.25,Debit,54929.12,,system,2025-06-08 17:17:13.605523,system,2025-06-08 17:17:13.605523
8e7396970f35427388eccb173f84b36c,e717275b4e0242a99ce7561f3164a553,2025-04-09,Yet accept sit hotel.,3410.96,Credit,58340.08,,system,2025-06-08 17:17:13.605523,system,2025-06-08 17:17:13.605523
55f95667bc334070aa60c8ed014eb20a,e717275b4e0242a99ce7561f3164a553,2024-12-17,Church think without make.,374.71,Credit,58714.79,,system,2025-06-08 17:17:13.605523,system,2025-06-08 17:17:13.605523
0eb0256a3fcf4180a4f400eb8370134f,e717275b4e0242a99ce7561f3164a553,2025-05-17,Break leader still eye energy everyone.,1675.64,Credit,60390.43,,system,2025-06-08 17:17:13.605523,system,2025-06-08 17:17:13.605523
310e36f109254492a7e0960b06ed11f0,e717275b4e0242a99ce7561f3164a553,2024-12-11,Coach plan spring medical.,1485.13,Credit,61875.56,,system,2025-06-08 17:17:13.605523,system,2025-06-08 17:17:13.605523
a5a798ebd6834998ab1b065c9eb0f172,e717275b4e0242a99ce7561f3164a553,2025-04-07,Rock mind meeting education or factor lay.,-211.16,Debit,61664.4,,system,2025-06-08 17:17:13.605523,system,2025-06-08 17:17:13.605523
8c8fa3f011424b7387122dbf3a5873db,c6dc1926a21444c98f01fe907561570a,2025-01-06,Red expert area consumer hospital.,2382.79,Credit,52382.79,,system,2025-06-08 17:17:13.605523,system,2025-06-08 17:17:13.605523
c098374dd97a4f119a885ce9f79617fe,c6dc1926a21444c98f01fe907561570a,2025-01-29,Cause consumer two eye language tree information.,-4873.7,Debit,47509.09,,system,2025-06-08 17:17:13.605523,system,2025-06-08 17:17:13.605523
442c547425c04114984cdd3616eea488,c6dc1926a21444c98f01fe907561570a,2025-03-22,Soldier health kitchen.,925.11,Credit,48434.2,,system,2025-06-08 17:17:13.605523,system,2025-06-08 17:17:13.605523
dec983754e384742a09a06424d2a51f6,c6dc1926a21444c98f01fe907561570a,2025-02-19,Rather mother budget have technology her dog.,1480.16,Credit,49914.36,,system,2025-06-08 17:17:13.605523,system,2025-06-08 17:17:13.605523
d3e9e6c4565842648b129b294ade2272,c6dc1926a21444c98f01fe907561570a,2025-05-28,Military together while without poor radio benefit.,-178.57,Debit,49735.79,,system,2025-06-08 17:17:13.605523,system,2025-06-08 17:17:13.605523
3aec7e0167d94ba88ac4f6b6547762c7,c6dc1926a21444c98f01fe907561570a,2025-03-10,Money would opportunity generation.,-4572.58,Debit,45163.21,,system,2025-06-08 17:17:13.605523,system,2025-06-08 17:17:13.605523
450de5c5540845aea7f8fec3a2a60adf,c6dc1926a21444c98f01fe907561570a,2025-04-04,Throughout successful hot course information ok quality.,-3705.98,Debit,41457.23,,system,2025-06-08 17:17:13.605523,system,2025-06-08 17:17:13.605523
e90760c7b77041aa8f962f137323ede6,c6dc1926a21444c98f01fe907561570a,2025-05-14,College reach player high.,1987.49,Credit,43444.72,,system,2025-06-08 17:17:13.605523,system,2025-06-08 17:17:13.605523
ec450250012a44d0ab30c29dc341a6a1,c6dc1926a21444c98f01fe907561570a,2025-02-07,Agent couple though thank someone song sometimes.,2805.43,Credit,46250.15,,system,2025-06-08 17:17:13.605523,system,2025-06-08 17:17:13.605523
732b70cce5ac462c93a9bb3df96d80dc,c6dc1926a21444c98f01fe907561570a,2025-02-12,Tough guess share.,4133.25,Credit,50383.4,,system,2025-06-08 17:17:13.605523,system,2025-06-08 17:17:13.605523
2730ff87d91640d8b8b2b95fccbb3f45,474ff12687ff4f16acd372f06cb6b92d,2025-04-08,Eat foot girl machine six artist another.,-3858.6,Debit,46141.4,,system,2025-06-08 17:17:13.605523,system,2025-06-08 17:17:13.605523
7a1ed868691243ec954d9dc51eea8baa,474ff12687ff4f16acd372f06cb6b92d,2025-03-07,Tree suggest minute card material.,-2310.06,Debit,43831.34,,system,2025-06-08 17:17:13.605523,system,2025-06-08 17:17:13.605523
e73fc1eb81d74ed9b0b52711b65b5253,474ff12687ff4f16acd372f06cb6b92d,2025-06-01,Board story support state western successful.,3713.62,Credit,47544.96,,system,2025-06-08 17:17:13.605523,system,2025-06-08 17:17:13.605523
18a9b5f7f813490da0507335cd982a39,474ff12687ff4f16acd372f06cb6b92d,2024-12-19,Drug from speak if let measure.,2944.56,Credit,50489.52,,system,2025-06-08 17:17:13.605523,system,2025-06-08 17:17:13.605523
b8482a3cb824443fb0d30729928d78ab,474ff12687ff4f16acd372f06cb6b92d,2025-01-04,Be produce whatever natural eat process.,331.33,Credit,50820.85,,system,2025-06-08 17:17:13.605523,system,2025-06-08 17:17:13.605523
aa9439f6325c4b00ab63c2245a149676,474ff12687ff4f16acd372f06cb6b92d,2025-04-23,Term food green cover sometimes point.,-1793.59,Debit,49027.26,,system,2025-06-08 17:17:13.605523,system,2025-06-08 17:17:13.605523
df8e6588edf64cd1aba5304b87b97dd7,474ff12687ff4f16acd372f06cb6b92d,2025-06-07,Other clearly theory actually other pay sit.,-2833.08,Debit,46194.18,,system,2025-06-08 17:17:13.605523,system,2025-06-08 17:17:13.605523
5fa6def175cc4eadac7a42c61326cce2,474ff12687ff4f16acd372f06cb6b92d,2025-05-19,Continue special indeed.,290.86,Credit,46485.04,,system,2025-06-08 17:17:13.605523,system,2025-06-08 17:17:13.605523
51f6e09534cc4beb9c3e87a453faa4b1,474ff12687ff4f16acd372f06cb6b92d,2025-01-10,Energy similar pull teach.,2647.48,Credit,49132.52,,system,2025-06-08 17:17:13.605523,system,2025-06-08 17:17:13.605523
b29ac96db6db4794bf65175f12ec522a,474ff12687ff4f16acd372f06cb6b92d,2024-12-31,Sea campaign notice base mind single politics.,2534.75,Credit,51667.27,,system,2025-06-08 17:17:13.605523,system,2025-06-08 17:17:13.605523
612b6fbc5c2847e0b2d3a877473d510c,d5db12a7b9b547d983323ab850cf4082,2024-12-26,Manage positive reveal season.,-2351.69,Debit,47648.31,,system,2025-06-08 17:17:13.605523,system,2025-06-08 17:17:13.605523
08e5ef5ff5b34ae3ab8b4673b58b6b0f,d5db12a7b9b547d983323ab850cf4082,2025-04-03,Happy notice finally quickly walk cause.,-1960.68,Debit,45687.63,,system,2025-06-08 17:17:13.605523,system,2025-06-08 17:17:13.605523
b559f5087aa44278922f90daa1872e0f,d5db12a7b9b547d983323ab850cf4082,2025-02-21,Strategy bed month.,4347.4,Credit,50035.03,,system,2025-06-08 17:17:13.605523,system,2025-06-08 17:17:13.605523
3c71b08af63a4539bf9dc857a7891c95,d5db12a7b9b547d983323ab850cf4082,2025-05-03,Always hotel phone street first bank stay.,1055.08,Credit,51090.11,,system,2025-06-08 17:17:13.605523,system,2025-06-08 17:17:13.605523
6c7310735f1d413abeb0e33208d0e715,d5db12a7b9b547d983323ab850cf4082,2025-03-12,Full kind school letter.,1168.35,Credit,52258.46,,system,2025-06-08 17:17:13.605523,system,2025-06-08 17:17:13.605523
a103fa971a9f468494279c487b6a7af4,d5db12a7b9b547d983323ab850cf4082,2025-05-10,Themselves TV off law.,-1615.68,Debit,50642.78,,system,2025-06-08 17:17:13.605523,system,2025-06-08 17:17:13.605523
2156d0e05d0e457984793c013971ad58,d5db12a7b9b547d983323ab850cf4082,2025-02-12,Within land street under clear whom.,1000.4,Credit,51643.18,,system,2025-06-08 17:17:13.605523,system,2025-06-08 17:17:13.605523
67597e3966de4f1585daf3063c5d4fb3,d5db12a7b9b547d983323ab850cf4082,2025-05-19,Pm use bring natural all too.,-722.14,Debit,50921.04,,system,2025-06-08 17:17:13.605523,system,2025-06-08 17:17:13.605523
073f756876494f0e8cba3d2e115540a3,d5db12a7b9b547d983323ab850cf4082,2025-02-14,Simply practice newspaper care.,-2636.73,Debit,48284.31,,system,2025-06-08 17:17:13.605523,system,2025-06-08 17:17:13.605523
4ec2f1305729408da86c4ce778b6a34a,d5db12a7b9b547d983323ab850cf4082,2025-05-10,Hold interesting heart.,2343.62,Credit,50627.93,,system,2025-06-08 17:17:13.605523,system,2025-06-08 17:17:13.605523
5c287c512b434844bae8124e199f50e3,6f648729e725416d964b5328ae34d0dc,2024-12-18,Safe how sense region skin human recognize.,1880.99,Credit,51880.99,,system,2025-06-08 17:17:13.605523,system,2025-06-08 17:17:13.605523
a395fa23dc4b420e8ec5211db958b5f7,6f648729e725416d964b5328ae34d0dc,2025-02-22,Medical myself statement moment.,10.26,Credit,51891.25,,system,2025-06-08 17:17:13.605523,system,2025-06-08 17:17:13.605523
9c840fe8d0934d32920c421f2a226deb,6f648729e725416d964b5328ae34d0dc,2025-02-20,Something night direction.,2500.84,Credit,54392.09,,system,2025-06-08 17:17:13.605523,system,2025-06-08 17:17:13.605523
0bc956639dc4486383af3bcd4a9fca91,6f648729e725416d964b5328ae34d0dc,2025-03-10,Ten case out dark behind job.,-2594.82,Debit,51797.27,,system,2025-06-08 17:17:13.605523,system,2025-06-08 17:17:13.605523
9c3581d1c011483498b67ac169ae417c,6f648729e725416d964b5328ae34d0dc,2025-05-05,Nothing his over that.,-992.08,Debit,50805.19,,system,2025-06-08 17:17:13.605523,system,2025-06-08 17:17:13.605523
2ce1321e4d0f42868f8a325c8071bfe4,6f648729e725416d964b5328ae34d0dc,2025-03-03,Nation firm surface window now.,2421.85,Credit,53227.04,,system,2025-06-08 17:17:13.605523,system,2025-06-08 17:17:13.605523
1b3430fb21b64cf7b0345ca61f18091e,6f648729e725416d964b5328ae34d0dc,2025-02-16,History add party medical.,4236.67,Credit,57463.71,,system,2025-06-08 17:17:13.605523,system,2025-06-08 17:17:13.605523
f4da3bec7bca47b6a203b15090694db6,6f648729e725416d964b5328ae34d0dc,2025-06-02,Couple affect six law sea.,439.03,Credit,57902.74,,system,2025-06-08 17:17:13.605523,system,2025-06-08 17:17:13.605523
ecd5321e540f4d4fa8b71c443b06d68d,6f648729e725416d964b5328ae34d0dc,2025-02-02,Require others early data standard direction officer.,-1277.45,Debit,56625.29,,system,2025-06-08 17:17:13.605523,system,2025-06-08 17:17:13.605523
c02d19e7939f4f5e99e8de7ee585dde7,6f648729e725416d964b5328ae34d0dc,2025-05-14,Society place pick through.,-2925.27,Debit,53700.02,,system,2025-06-08 17:17:13.605523,system,2025-06-08 17:17:13.605523
ddae86ce5b3c4af686a9524877dfd756,6d696f8f1cf843acb8fb7d18ce468a65,2025-01-25,Degree discuss control choose leave.,-3044.03,Debit,46955.97,,system,2025-06-08 17:17:13.605523,system,2025-06-08 17:17:13.605523
f910dd74585b4d068ec8d8c278353095,6d696f8f1cf843acb8fb7d18ce468a65,2025-03-27,Amount voice peace month.,-221.73,Debit,46734.24,,system,2025-06-08 17:17:13.605523,system,2025-06-08 17:17:13.605523
45709dec58444dfea2dcb54005e1df0e,6d696f8f1cf843acb8fb7d18ce468a65,2025-05-28,Country international true.,3231.64,Credit,49965.88,,system,2025-06-08 17:17:13.605523,system,2025-06-08 17:17:13.605523
0c0a29d0a1c442f3848d6704dbf08748,6d696f8f1cf843acb8fb7d18ce468a65,2025-05-04,Either political bring upon behind exist federal.,-3341.27,Debit,46624.61,,system,2025-06-08 17:17:13.605523,system,2025-06-08 17:17:13.605523
8fad0f20ed0c4ee49eff3c1eadf37009,6d696f8f1cf843acb8fb7d18ce468a65,2024-12-23,Degree season by manage.,-2825.85,Debit,43798.76,,system,2025-06-08 17:17:13.605523,system,2025-06-08 17:17:13.605523
64648f646247428cbdb481e0c5652642,6d696f8f1cf843acb8fb7d18ce468a65,2025-03-27,Rich my do strong compare deal.,4276.29,Credit,48075.05,,system,2025-06-08 17:17:13.605523,system,2025-06-08 17:17:13.605523
76eff4d6f4b94cf6ad7f83c458719540,6d696f8f1cf843acb8fb7d18ce468a65,2025-05-22,Focus create five pretty third as enter.,1672.17,Credit,49747.22,,system,2025-06-08 17:17:13.605523,system,2025-06-08 17:17:13.605523
32c5c949ed8d40b68db9d6c737bcb8f8,6d696f8f1cf843acb8fb7d18ce468a65,2025-02-28,Feel identify attack own positive positive explain.,-1980.74,Debit,47766.48,,system,2025-06-08 17:17:13.605523,system,2025-06-08 17:17:13.605523
cc116e860cfd4fd497aac56cbe76bbbf,6d696f8f1cf843acb8fb7d18ce468a65,2025-04-24,Explain range mission could.,3857.46,Credit,51623.94,,system,2025-06-08 17:17:13.605523,system,2025-06-08 17:17:13.605523
5afaf3b7b82d4afc862904642d340b2c,6d696f8f1cf843acb8fb7d18ce468a65,2025-04-17,Manager feeling recognize me among establish at.,-57.61,Debit,51566.33,,system,2025-06-08 17:17:13.605523,system,2025-06-08 17:17:13.605523
de771d2c820b4c598ce65bdcc0cd0604,ba4a26ef07334ce3b0d9b93696315012,2025-06-08,Nature learn city recent spring.,2275.21,Credit,52275.21,,system,2025-06-08 17:17:13.605523,system,2025-06-08 17:17:13.605523
51a82624eda94e88b325c2daad53788b,ba4a26ef07334ce3b0d9b93696315012,2024-12-16,Exist year hotel time ago serve hand.,-2031.43,Debit,50243.78,,system,2025-06-08 17:17:13.605523,system,2025-06-08 17:17:13.605523
d6039effa98948ee8f54c86391d07ab0,ba4a26ef07334ce3b0d9b93696315012,2025-02-11,Child catch future during name.,-3895.5,Debit,46348.28,,system,2025-06-08 17:17:13.605523,system,2025-06-08 17:17:13.605523
5f51372afb494153a3a5d48f48b68d8b,ba4a26ef07334ce3b0d9b93696315012,2025-05-15,Range age live mission argue better however.,-839.04,Debit,45509.24,,system,2025-06-08 17:17:13.605523,system,2025-06-08 17:17:13.605523
22a2d44bfddf47ab8e3b71df902081ed,ba4a26ef07334ce3b0d9b93696315012,2025-04-25,Small let commercial always.,1841.98,Credit,47351.22,,system,2025-06-08 17:17:13.605523,system,2025-06-08 17:17:13.605523
dc56037703bb471ebd4cfd4be2e11675,ba4a26ef07334ce3b0d9b93696315012,2025-05-13,Window eye deep paper energy raise themselves stock.,1262.09,Credit,48613.31,,system,2025-06-08 17:17:13.605523,system,2025-06-08 17:17:13.605523
378f11c53a2a485c843d7a9204f29efd,ba4a26ef07334ce3b0d9b93696315012,2025-03-25,Soon ability manager claim clear factor affect.,-1254.07,Debit,47359.24,,system,2025-06-08 17:17:13.605523,system,2025-06-08 17:17:13.605523
5adeac76ed89478da3ef0f71cfe5c1f9,ba4a26ef07334ce3b0d9b93696315012,2025-05-11,Just month agency note show page do.,113.59,Credit,47472.83,,system,2025-06-08 17:17:13.605523,system,2025-06-08 17:17:13.605523
0f1d9e9a92ee4a6daabf1a3ff8e72220,ba4a26ef07334ce3b0d9b93696315012,2025-01-23,Mr short may pick.,1009.65,Credit,48482.48,,system,2025-06-08 17:17:13.605523,system,2025-06-08 17:17:13.605523
73861af480f944e2b09110ee072044a9,ba4a26ef07334ce3b0d9b93696315012,2025-04-16,Play rise production vote.,2371.22,Credit,50853.7,,system,2025-06-08 17:17:13.605523,system,2025-06-08 17:17:13.605523
70f393b7a4294d3796f660f774436cf0,7ba454befbd0495289681cb77d21f02a,2025-02-22,Nation school whether according most learn woman effort.,3871.75,Credit,53871.75,,system,2025-06-08 17:17:13.605523,system,2025-06-08 17:17:13.605523
f52ffe1b7d774eaf88c9fab94b6429a3,7ba454befbd0495289681cb77d21f02a,2025-06-02,Take we peace she such.,-2380.68,Debit,51491.07,,system,2025-06-08 17:17:13.605523,system,2025-06-08 17:17:13.605523
a48cbae6c3174952884379ef4e2af2ee,7ba454befbd0495289681cb77d21f02a,2025-03-01,Rest enough source beautiful son strategy item recently.,3417.19,Credit,54908.26,,system,2025-06-08 17:17:13.605523,system,2025-06-08 17:17:13.605523
54c0bc9f43e643a49d2ff4bf3898d08f,7ba454befbd0495289681cb77d21f02a,2025-01-22,Southern reality religious nice effect quality could while.,-1868.06,Debit,53040.2,,system,2025-06-08 17:17:13.605523,system,2025-06-08 17:17:13.605523
65651011a2b1425c8622d7fac2301fa9,7ba454befbd0495289681cb77d21f02a,2025-03-01,Short wall standard order recent blue attorney stay.,4769.57,Credit,57809.77,,system,2025-06-08 17:17:13.605523,system,2025-06-08 17:17:13.605523
3e52504576754465b15bd6bde081bd9a,7ba454befbd0495289681cb77d21f02a,2025-02-05,Chair attack decision color worry away.,931.55,Credit,58741.32,,system,2025-06-08 17:17:13.605523,system,2025-06-08 17:17:13.605523
2254d1f6c658469a8492268b1067f4cc,7ba454befbd0495289681cb77d21f02a,2025-04-14,Able beautiful occur where should.,4269.73,Credit,63011.05,,system,2025-06-08 17:17:13.605523,system,2025-06-08 17:17:13.605523
3d67c7b652be4f1e800f65fd52c04667,7ba454befbd0495289681cb77d21f02a,2025-01-16,Peace direction couple them.,-1225.96,Debit,61785.09,,system,2025-06-08 17:17:13.605523,system,2025-06-08 17:17:13.605523
6e664c2817af409c994a1e47a61cedf4,7ba454befbd0495289681cb77d21f02a,2025-04-10,Culture attention vote if church hard.,2794.1,Credit,64579.19,,system,2025-06-08 17:17:13.605523,system,2025-06-08 17:17:13.605523
9978d8fd16684ea39107b992f06b9cb7,7ba454befbd0495289681cb77d21f02a,2025-03-29,Shoulder employee child movie.,-4970.1,Debit,59609.09,,system,2025-06-08 17:17:13.605523,system,2025-06-08 17:17:13.605523
88bdf82b85b14422be45c14a1fc63701,4fa78d3514a24cc98b24c61d81442863,2025-02-04,Two ever share plan few we.,412.84,Credit,50412.84,,system,2025-06-08 17:17:13.605523,system,2025-06-08 17:17:13.605523
89766e01434d46428ae46f51aa8fb453,4fa78d3514a24cc98b24c61d81442863,2024-12-26,Force four safe.,1829.11,Credit,52241.95,,system,2025-06-08 17:17:13.605523,system,2025-06-08 17:17:13.605523
b9dd719823b24a80b28f83772f0028b0,4fa78d3514a24cc98b24c61d81442863,2025-04-11,Apply energy should quickly.,-2721.63,Debit,49520.32,,system,2025-06-08 17:17:13.605523,system,2025-06-08 17:17:13.605523
cb8cc4da55804bdab5755c3f15d524d0,4fa78d3514a24cc98b24c61d81442863,2025-05-19,Son evidence science risk particular.,1900.95,Credit,51421.27,,system,2025-06-08 17:17:13.605523,system,2025-06-08 17:17:13.605523
56372cb06d3d40149deeff5ad43f628e,4fa78d3514a24cc98b24c61d81442863,2025-01-12,Cup year provide new article early.,2655.08,Credit,54076.35,,system,2025-06-08 17:17:13.605523,system,2025-06-08 17:17:13.605523
8f97428454b3423bbd50872313e2821b,4fa78d3514a24cc98b24c61d81442863,2025-05-02,Human dinner fly team.,4755.3,Credit,58831.65,,system,2025-06-08 17:17:13.605523,system,2025-06-08 17:17:13.605523
c4b39f9684934461bfffdd7982a3cc01,4fa78d3514a24cc98b24c61d81442863,2024-12-10,Increase southern so reason bring fight call.,2794.64,Credit,61626.29,,system,2025-06-08 17:17:13.605523,system,2025-06-08 17:17:13.605523
2024ae255f6f45eeab0da6a0a649d991,4fa78d3514a24cc98b24c61d81442863,2025-01-07,Nothing age new hard top could.,4878.31,Credit,66504.6,,system,2025-06-08 17:17:13.605523,system,2025-06-08 17:17:13.605523
0813fb915bb0449e8abfb67ffbb60076,4fa78d3514a24cc98b24c61d81442863,2024-12-26,Enter take can should one control camera.,-3863.85,Debit,62640.75,,system,2025-06-08 17:17:13.605523,system,2025-06-08 17:17:13.605523
390fd41a4e53423da953229c0c56412c,4fa78d3514a24cc98b24c61d81442863,2025-05-25,Network woman staff agent shoulder whatever dinner.,-3323.33,Debit,59317.42,,system,2025-06-08 17:17:13.605523,system,2025-06-08 17:17:13.605523
33a4e8d54872433791e54fba95c11268,9db49220829740ec8521b6e444b259d9,2025-01-06,Tax head grow big present doctor camera.,-1166.98,Debit,48833.02,,system,2025-06-08 17:17:13.605523,system,2025-06-08 17:17:13.605523
65b8a20abfb54e5d9490dd754ddda908,9db49220829740ec8521b6e444b259d9,2025-05-23,Your buy toward left.,-2769.46,Debit,46063.56,,system,2025-06-08 17:17:13.605523,system,2025-06-08 17:17:13.605523
cdcc6c7e9b7c4a658cfc24cbe96ed1a3,9db49220829740ec8521b6e444b259d9,2025-04-02,Officer third cover now when south throughout.,-4563.19,Debit,41500.37,,system,2025-06-08 17:17:13.605523,system,2025-06-08 17:17:13.605523
73b648f80bd74d5189066edab2449060,9db49220829740ec8521b6e444b259d9,2024-12-15,Smile must nature collection where international television.,-4501.2,Debit,36999.17,,system,2025-06-08 17:17:13.605523,system,2025-06-08 17:17:13.605523
d0b2d0d1ef824b8ab5220514cd132416,9db49220829740ec8521b6e444b259d9,2025-05-15,Business share book his let already present.,-3548.46,Debit,33450.71,,system,2025-06-08 17:17:13.605523,system,2025-06-08 17:17:13.605523
5c7f2673ebc241969522aa3a1a88b93e,9db49220829740ec8521b6e444b259d9,2025-02-13,Compare account feel economic many.,-4180.44,Debit,29270.27,,system,2025-06-08 17:17:13.605523,system,2025-06-08 17:17:13.605523
bb05d10c02dd40aab4cd6c647e2311b3,9db49220829740ec8521b6e444b259d9,2025-01-28,Article with but nation board paper.,-3296.61,Debit,25973.66,,system,2025-06-08 17:17:13.605523,system,2025-06-08 17:17:13.605523
5a9ce3ef17484a8494b36a4ce2c8cf6a,9db49220829740ec8521b6e444b259d9,2025-02-06,Amount region from high.,-3431.22,Debit,22542.44,,system,2025-06-08 17:17:13.605523,system,2025-06-08 17:17:13.605523
0f9f32d425184b5f9eb556de1e2ff185,9db49220829740ec8521b6e444b259d9,2025-04-20,Mission mention art letter teach home contain paper.,-3759.23,Debit,18783.21,,system,2025-06-08 17:17:13.605523,system,2025-06-08 17:17:13.605523
f688d1c6053e4be4bcd1cb6e3470b139,9db49220829740ec8521b6e444b259d9,2025-01-22,Physical surface foreign even allow.,-4795.78,Debit,13987.43,,system,2025-06-08 17:17:13.605523,system,2025-06-08 17:17:13.605523
b70ddc1be8074303949c4c1949166beb,865d47f95e8043f38c98b162013651a1,2024-12-12,Recent issue its positive realize series such.,-3857.87,Debit,46142.13,,system,2025-06-08 17:17:13.605523,system,2025-06-08 17:17:13.605523
eeaca71037d5495fa0f4a915c907c35e,865d47f95e8043f38c98b162013651a1,2025-02-26,Skill speak write audience dark.,833.89,Credit,46976.02,,system,2025-06-08 17:17:13.605523,system,2025-06-08 17:17:13.605523
a4bddd52981a45dab324a2266c6be694,865d47f95e8043f38c98b162013651a1,2025-02-06,Beautiful cover reveal town clearly throughout night Mrs.,1520.04,Credit,48496.06,,system,2025-06-08 17:17:13.605523,system,2025-06-08 17:17:13.605523
1ee121773127480480514066458567be,865d47f95e8043f38c98b162013651a1,2025-02-14,Message hour truth speech teach.,-1653.34,Debit,46842.72,,system,2025-06-08 17:17:13.605523,system,2025-06-08 17:17:13.605523
0fe0963937ac4528b14ed57bb105120c,865d47f95e8043f38c98b162013651a1,2025-01-26,Beat station resource organization throw model scene.,258.2,Credit,47100.92,,system,2025-06-08 17:17:13.605523,system,2025-06-08 17:17:13.605523
7ac7a12a15e14581a028d92a98a7a1c2,865d47f95e8043f38c98b162013651a1,2025-01-12,Property maintain mean dream.,1561.69,Credit,48662.61,,system,2025-06-08 17:17:13.605523,system,2025-06-08 17:17:13.605523
0b84bea95a1a43be8b612d12d4618352,865d47f95e8043f38c98b162013651a1,2025-03-28,Hair defense necessary foot.,-229.36,Debit,48433.25,,system,2025-06-08 17:17:13.605523,system,2025-06-08 17:17:13.605523
d6c08ecd0ea54126be21cebbaae4ae5e,865d47f95e8043f38c98b162013651a1,2025-02-14,Hair although you rise no management.,816.35,Credit,49249.6,,system,2025-06-08 17:17:13.605523,system,2025-06-08 17:17:13.605523
310dc1ecd97c4c9daba6fb0c4461dda7,865d47f95e8043f38c98b162013651a1,2025-05-25,Trouble more message far.,1242.82,Credit,50492.42,,system,2025-06-08 17:17:13.605523,system,2025-06-08 17:17:13.605523
73790c6303194948aa8ccce45388ba01,865d47f95e8043f38c98b162013651a1,2025-05-05,Soldier capital own tonight hold girl shake.,-1842.76,Debit,48649.66,,system,2025-06-08 17:17:13.605523,system,2025-06-08 17:17:13.605523
f5ef726305314618bf8dd232611c1c8e,623a8c27712f48f19306dd6107f7510f,2025-05-08,Resource magazine art door.,-3935.44,Debit,46064.56,,system,2025-06-08 17:17:13.605523,system,2025-06-08 17:17:13.605523
d47d1956967a47bd8a625c02d72bbdf1,623a8c27712f48f19306dd6107f7510f,2025-01-20,Customer international sea size director husband.,-3896.21,Debit,42168.35,,system,2025-06-08 17:17:13.605523,system,2025-06-08 17:17:13.605523
d786426d7e284bbeb9b4b8f2697913fe,623a8c27712f48f19306dd6107f7510f,2025-03-15,Compare pick song attention.,3536.67,Credit,45705.02,,system,2025-06-08 17:17:13.605523,system,2025-06-08 17:17:13.605523
0b051216e9ba4b7f86d2ba111c65cc38,623a8c27712f48f19306dd6107f7510f,2025-03-09,Senior join list interesting.,4878.45,Credit,50583.47,,system,2025-06-08 17:17:13.605523,system,2025-06-08 17:17:13.605523
665e9a684e094bb7848be71c4a24ef9e,623a8c27712f48f19306dd6107f7510f,2025-05-15,Argue everything make consider read reveal dog.,167.84,Credit,50751.31,,system,2025-06-08 17:17:13.605523,system,2025-06-08 17:17:13.605523
985f541680414e4593f816f4e7d859e3,623a8c27712f48f19306dd6107f7510f,2025-01-23,Travel force decide improve turn law range.,528.92,Credit,51280.23,,system,2025-06-08 17:17:13.605523,system,2025-06-08 17:17:13.605523
91e6e74df51f494881ce0b2b478998f0,623a8c27712f48f19306dd6107f7510f,2025-06-06,Expert task give structure community low here.,1629.1,Credit,52909.33,,system,2025-06-08 17:17:13.605523,system,2025-06-08 17:17:13.605523
c4f71c00bc914a308a0817c57da4b785,623a8c27712f48f19306dd6107f7510f,2025-02-02,Management live according program girl.,-673.31,Debit,52236.02,,system,2025-06-08 17:17:13.605523,system,2025-06-08 17:17:13.605523
2e73f8cc7a8d447497699e071a55bd94,623a8c27712f48f19306dd6107f7510f,2024-12-15,Finish sense suddenly.,-2887.41,Debit,49348.61,,system,2025-06-08 17:17:13.605523,system,2025-06-08 17:17:13.605523
13aefa81214c4887af9d95269b6e3de0,623a8c27712f48f19306dd6107f7510f,2024-12-10,International be benefit tell professional.,3541.56,Credit,52890.17,,system,2025-06-08 17:17:13.605523,system,2025-06-08 17:17:13.605523
7361fe8f584942409932e7fe84885b4d,cc2b787b47914f54bd57b479ee581b0a,2025-04-07,At guy enough consider both power remain girl.,-1866.17,Debit,48133.83,,system,2025-06-08 17:17:13.605523,system,2025-06-08 17:17:13.605523
fcb0d543127d4bcd9d1ff5566b098010,cc2b787b47914f54bd57b479ee581b0a,2025-02-24,Attorney reason act message baby.,-4052.87,Debit,44080.96,,system,2025-06-08 17:17:13.605523,system,2025-06-08 17:17:13.605523
6ac330286523431281e97e7b42cb96c1,cc2b787b47914f54bd57b479ee581b0a,2025-05-15,Ready significant buy good piece box.,-2998.84,Debit,41082.12,,system,2025-06-08 17:17:13.605523,system,2025-06-08 17:17:13.605523
df319076b076435eae63aff4ec722fe1,cc2b787b47914f54bd57b479ee581b0a,2025-02-10,Affect future far.,-3318.37,Debit,37763.75,,system,2025-06-08 17:17:13.605523,system,2025-06-08 17:17:13.605523
4b4911d48df840eeaa743ab3211f1f7c,cc2b787b47914f54bd57b479ee581b0a,2025-03-07,Choice sea listen the much message environment.,4810.7,Credit,42574.45,,system,2025-06-08 17:17:13.605523,system,2025-06-08 17:17:13.605523
c18ae22a6a4244d8ad6ba078b760252e,cc2b787b47914f54bd57b479ee581b0a,2025-02-14,Around charge successful through television speak.,3328.03,Credit,45902.48,,system,2025-06-08 17:17:13.605523,system,2025-06-08 17:17:13.605523
73e9ee1420a7454e90145e193810e5a9,cc2b787b47914f54bd57b479ee581b0a,2025-02-22,Marriage many maybe front again.,3179.76,Credit,49082.24,,system,2025-06-08 17:17:13.605523,system,2025-06-08 17:17:13.605523
0d472eaa9e61451a83c1bc6f78f68fa7,cc2b787b47914f54bd57b479ee581b0a,2025-01-07,Reveal those his institution crime.,-3966.44,Debit,45115.8,,system,2025-06-08 17:17:13.605523,system,2025-06-08 17:17:13.605523
6e57b6e341c543ed969b70a246efc0c0,cc2b787b47914f54bd57b479ee581b0a,2025-02-23,Forward enough forget believe happen.,-1949.12,Debit,43166.68,,system,2025-06-08 17:17:13.605523,system,2025-06-08 17:17:13.605523
e33dc2fadf2a45519fcb11a96c6f07c0,cc2b787b47914f54bd57b479ee581b0a,2025-01-16,News develop now help issue girl town lot.,-2820.81,Debit,40345.87,,system,2025-06-08 17:17:13.605523,system,2025-06-08 17:17:13.605523
13d335a97099418fad38f82c24db37ce,c847e049dedd44399cfad156e7e02ce6,2025-05-17,Garden wait space make guy rise attorney threat.,71.17,Credit,50071.17,,system,2025-06-08 17:17:13.605523,system,2025-06-08 17:17:13.605523
f74f6139c6d845229dc091c8ca16d7d6,c847e049dedd44399cfad156e7e02ce6,2025-04-15,Major still however matter.,739.59,Credit,50810.76,,system,2025-06-08 17:17:13.605523,system,2025-06-08 17:17:13.605523
b83a267095324665a6a17e05beb9e7d0,c847e049dedd44399cfad156e7e02ce6,2024-12-14,Prepare fund free magazine.,255.56,Credit,51066.32,,system,2025-06-08 17:17:13.605523,system,2025-06-08 17:17:13.605523
e377a1dbffa54c539f1582137e5a26fa,c847e049dedd44399cfad156e7e02ce6,2024-12-25,Including light look age entire affect have.,2105.27,Credit,53171.59,,system,2025-06-08 17:17:13.605523,system,2025-06-08 17:17:13.605523
68468da71a934b049d510de67dd6a614,c847e049dedd44399cfad156e7e02ce6,2025-01-10,Candidate heavy fear policy card let.,807.62,Credit,53979.21,,system,2025-06-08 17:17:13.605523,system,2025-06-08 17:17:13.605523
279528e004e54978b36314794ed2fb10,c847e049dedd44399cfad156e7e02ce6,2025-01-24,Mrs until head.,-4464.48,Debit,49514.73,,system,2025-06-08 17:17:13.605523,system,2025-06-08 17:17:13.605523
4fa7e6537ddd47939c07ae4afedc9bf7,c847e049dedd44399cfad156e7e02ce6,2025-04-27,Hospital act boy open consumer exactly include day.,4780.3,Credit,54295.03,,system,2025-06-08 17:17:13.605523,system,2025-06-08 17:17:13.605523
dd0a20d6f3e3493987d139b331a55f25,c847e049dedd44399cfad156e7e02ce6,2025-05-10,Around commercial activity others opportunity cell.,1976.99,Credit,56272.02,,system,2025-06-08 17:17:13.605523,system,2025-06-08 17:17:13.605523
3cffccfd1c2b4b45beff5e53e6662f49,c847e049dedd44399cfad156e7e02ce6,2024-12-26,Edge finally purpose entire compare room blood.,2636.1,Credit,58908.12,,system,2025-06-08 17:17:13.605523,system,2025-06-08 17:17:13.605523
d524ba0ddaa648ebaadf8a45aa300c62,c847e049dedd44399cfad156e7e02ce6,2025-02-01,System society baby imagine throw pressure.,3232.98,Credit,62141.1,,system,2025-06-08 17:17:13.605523,system,2025-06-08 17:17:13.605523
bc2b2f2ad8a84f949ed42d6dc9771bdb,3a94304673f143709844f7c5e3dac5c3,2025-02-02,Trade among stage main way quite.,-4231.4,Debit,45768.6,,system,2025-06-08 17:17:13.605523,system,2025-06-08 17:17:13.605523
d04e70fda5624917858aea5838c355aa,3a94304673f143709844f7c5e3dac5c3,2024-12-16,Together phone event civil.,-1519.41,Debit,44249.19,,system,2025-06-08 17:17:13.605523,system,2025-06-08 17:17:13.605523
de91664428044a0382bfb22275eb30d2,3a94304673f143709844f7c5e3dac5c3,2025-05-10,Thank adult notice develop.,1956.07,Credit,46205.26,,system,2025-06-08 17:17:13.605523,system,2025-06-08 17:17:13.605523
b78dc166a172439a863b7751aa73d8df,3a94304673f143709844f7c5e3dac5c3,2024-12-14,Section also there series air.,-1109.83,Debit,45095.43,,system,2025-06-08 17:17:13.605523,system,2025-06-08 17:17:13.605523
6dc32df34e7c49a197ec40ca75f9c782,3a94304673f143709844f7c5e3dac5c3,2025-05-09,Begin include bring pretty you someone dog day.,-3055.3,Debit,42040.13,,system,2025-06-08 17:17:13.605523,system,2025-06-08 17:17:13.605523
704279e1832041f88e729ac2cac34ba3,3a94304673f143709844f7c5e3dac5c3,2025-04-08,About modern stay seek become also stock.,3023.3,Credit,45063.43,,system,2025-06-08 17:17:13.605523,system,2025-06-08 17:17:13.605523
a03b3579b0ed48eea690efce62e45993,3a94304673f143709844f7c5e3dac5c3,2025-01-02,Only question how drop north.,-4231.18,Debit,40832.25,,system,2025-06-08 17:17:13.605523,system,2025-06-08 17:17:13.605523
363e09e269d241b39a6f57f4e0cb4d36,3a94304673f143709844f7c5e3dac5c3,2025-03-16,Minute including pick play election.,3609.83,Credit,44442.08,,system,2025-06-08 17:17:13.605523,system,2025-06-08 17:17:13.605523
80e9a0908d5e4fa585dadd8ac6d321aa,3a94304673f143709844f7c5e3dac5c3,2025-05-30,Story rich skill site why.,-2322.39,Debit,42119.69,,system,2025-06-08 17:17:13.605523,system,2025-06-08 17:17:13.605523
5a40966d32f947f28cdcc417ada5c388,3a94304673f143709844f7c5e3dac5c3,2025-05-28,Break back either artist however theory well.,2543.13,Credit,44662.82,,system,2025-06-08 17:17:13.605523,system,2025-06-08 17:17:13.605523
5167f8da2a7e4b2791bae1253b781149,c23102bfa1af4434bf7b8ace596589b2,2025-01-05,Suddenly protect team boy.,-1895.28,Debit,48104.72,,system,2025-06-08 17:17:13.605523,system,2025-06-08 17:17:13.605523
4a07c993e40844d3b013b8ed4532d4ce,c23102bfa1af4434bf7b8ace596589b2,2025-04-07,Run other possible soldier these.,3347.94,Credit,51452.66,,system,2025-06-08 17:17:13.605523,system,2025-06-08 17:17:13.605523
f322e67bb29045e6b3fbdb5680ce49bd,c23102bfa1af4434bf7b8ace596589b2,2025-04-28,Thousand can even practice.,-237.78,Debit,51214.88,,system,2025-06-08 17:17:13.605523,system,2025-06-08 17:17:13.605523
1a8bf3805a7942a4b9fee8a726fcd3a4,c23102bfa1af4434bf7b8ace596589b2,2025-03-25,Current seek happy tough read.,1013.77,Credit,52228.65,,system,2025-06-08 17:17:13.605523,system,2025-06-08 17:17:13.605523
a9fe95f9bf9e485a9d4685d8820eb4e0,c23102bfa1af4434bf7b8ace596589b2,2025-03-15,Claim recognize idea support international price.,-1284.28,Debit,50944.37,,system,2025-06-08 17:17:13.605523,system,2025-06-08 17:17:13.605523
4fce5c8b4b3e415f9a41725ec9669b2f,c23102bfa1af4434bf7b8ace596589b2,2025-03-13,Including see few behind back partner.,35.22,Credit,50979.59,,system,2025-06-08 17:17:13.605523,system,2025-06-08 17:17:13.605523
b6a2ec122f384f529f8fd19fb767016f,c23102bfa1af4434bf7b8ace596589b2,2025-04-09,Political glass respond measure beat much law.,1948.45,Credit,52928.04,,system,2025-06-08 17:17:13.605523,system,2025-06-08 17:17:13.605523
81d99434614645e4a6bcbb8302bdab50,c23102bfa1af4434bf7b8ace596589b2,2025-01-09,Close under even hit house window why bad.,1800.82,Credit,54728.86,,system,2025-06-08 17:17:13.605523,system,2025-06-08 17:17:13.605523
77cad8c761f7437caad489db6a6f0032,c23102bfa1af4434bf7b8ace596589b2,2025-05-08,Example ball everyone computer similar growth.,481.59,Credit,55210.45,,system,2025-06-08 17:17:13.605523,system,2025-06-08 17:17:13.605523
6f1538fa035b4112832aee2a80f4e5c3,c23102bfa1af4434bf7b8ace596589b2,2025-03-29,This performance just accept officer pretty sound.,-3468.51,Debit,51741.94,,system,2025-06-08 17:17:13.605523,system,2025-06-08 17:17:13.605523
39176802d6da48bbb25d3f83d31ba115,083774c275b64ac38f3793e4bc238ba4,2025-04-14,Several notice eight enough rise ahead over.,4991.91,Credit,54991.91,,system,2025-06-08 17:17:13.605523,system,2025-06-08 17:17:13.605523
8e3067ea2f2a4080aa3554aa0669a451,083774c275b64ac38f3793e4bc238ba4,2025-04-30,Miss probably country it outside join.,1037.57,Credit,56029.48,,system,2025-06-08 17:17:13.605523,system,2025-06-08 17:17:13.605523
5df8ff4741394837b1ccee16c44be46e,083774c275b64ac38f3793e4bc238ba4,2025-03-18,Leg information partner actually any rock opportunity.,-3545.0,Debit,52484.48,,system,2025-06-08 17:17:13.605523,system,2025-06-08 17:17:13.605523
9c16ba33b7284607be1ff5b8c31c1e46,083774c275b64ac38f3793e4bc238ba4,2025-03-13,Reveal occur of pick tell ok.,2771.96,Credit,55256.44,,system,2025-06-08 17:17:13.605523,system,2025-06-08 17:17:13.605523
e60728352b6f4a26b709c1b351582f75,083774c275b64ac38f3793e4bc238ba4,2025-03-31,Available computer itself trade.,-3941.59,Debit,51314.85,,system,2025-06-08 17:17:13.605523,system,2025-06-08 17:17:13.605523
38f112a082e546a9b23875d7f16db06c,083774c275b64ac38f3793e4bc238ba4,2025-01-06,Everything son maybe treat.,-4302.6,Debit,47012.25,,system,2025-06-08 17:17:13.605523,system,2025-06-08 17:17:13.605523
bbc864f8728d4ce69bb72b142b8b6e3c,083774c275b64ac38f3793e4bc238ba4,2025-04-22,Suddenly current like same protect.,2005.64,Credit,49017.89,,system,2025-06-08 17:17:13.605523,system,2025-06-08 17:17:13.605523
bf2eb4f10e5a49a693252b2dd0cd9f74,083774c275b64ac38f3793e4bc238ba4,2025-05-22,Race nice ever character might.,-1773.29,Debit,47244.6,,system,2025-06-08 17:17:13.605523,system,2025-06-08 17:17:13.605523
60dde64d81244b4aaf63c9e93cba0ca6,083774c275b64ac38f3793e4bc238ba4,2025-04-04,Sea help nice stock experience good.,1293.5,Credit,48538.1,,system,2025-06-08 17:17:13.605523,system,2025-06-08 17:17:13.605523
5ff6e4f0c1094fdba0f31a21d6760a9b,083774c275b64ac38f3793e4bc238ba4,2025-02-21,Give behavior total do bag agree fall.,3320.71,Credit,51858.81,,system,2025-06-08 17:17:13.605523,system,2025-06-08 17:17:13.605523
782f14b998dc4f0098d1785ad9ef1329,9335db8f8848421b88f76b9918ce722d,2025-05-12,Voice building boy front artist.,3980.3,Credit,53980.3,,system,2025-06-08 17:17:13.605523,system,2025-06-08 17:17:13.605523
adbbd367351049b69bcd8cbd63f9fac1,9335db8f8848421b88f76b9918ce722d,2025-04-23,Chair agent final bring leg.,3189.0,Credit,57169.3,,system,2025-06-08 17:17:13.605523,system,2025-06-08 17:17:13.605523
3a0cb3fe27f849f68b0dafff7b06bd67,9335db8f8848421b88f76b9918ce722d,2025-02-25,Adult sea down.,2066.68,Credit,59235.98,,system,2025-06-08 17:17:13.605523,system,2025-06-08 17:17:13.605523
7f20dab2848149d5966df87277294801,9335db8f8848421b88f76b9918ce722d,2025-05-08,Lawyer quickly husband spring election.,3110.98,Credit,62346.96,,system,2025-06-08 17:17:13.605523,system,2025-06-08 17:17:13.605523
2b31441857af4c91a1789cd0e550e32e,9335db8f8848421b88f76b9918ce722d,2025-02-27,Away ahead at represent home audience.,1962.14,Credit,64309.1,,system,2025-06-08 17:17:13.605523,system,2025-06-08 17:17:13.605523
58034a2da9a448e18ef8e5238e2301d6,9335db8f8848421b88f76b9918ce722d,2025-01-06,Seat consumer compare.,-2667.29,Debit,61641.81,,system,2025-06-08 17:17:13.605523,system,2025-06-08 17:17:13.605523
b0aaf9100de44f51a7b2e7f76100c908,9335db8f8848421b88f76b9918ce722d,2025-04-03,Since reach like place apply tree through.,-2388.8,Debit,59253.01,,system,2025-06-08 17:17:13.605523,system,2025-06-08 17:17:13.605523
ba9f5cf69d15442b8ebce6fea1743e6a,9335db8f8848421b88f76b9918ce722d,2025-04-16,Half follow quite administration.,-4023.32,Debit,55229.69,,system,2025-06-08 17:17:13.605523,system,2025-06-08 17:17:13.605523
fc8748c4f0484ce6a9c5294f39d39476,9335db8f8848421b88f76b9918ce722d,2025-01-17,Receive opportunity strong floor whose.,2233.28,Credit,57462.97,,system,2025-06-08 17:17:13.605523,system,2025-06-08 17:17:13.605523
de2b94450b4146bc90b7944e0c7f071d,9335db8f8848421b88f76b9918ce722d,2025-04-10,Also family among skill cell TV.,-2483.11,Debit,54979.86,,system,2025-06-08 17:17:13.605523,system,2025-06-08 17:17:13.605523
b516ff02a1964b74a91fd23ff76a17b3,796038a187fa417da4c1f62d6f39855c,2025-03-01,Light final television manage for sense.,-4061.84,Debit,45938.16,,system,2025-06-08 17:17:13.605523,system,2025-06-08 17:17:13.605523
7b8f186480af418dab29794a0851b5bc,796038a187fa417da4c1f62d6f39855c,2025-05-26,Certain start woman camera once could style.,-2823.72,Debit,43114.44,,system,2025-06-08 17:17:13.605523,system,2025-06-08 17:17:13.605523
e6901e2004374ab792f022697f0b1568,796038a187fa417da4c1f62d6f39855c,2025-06-06,Public to character affect partner rest senior fast.,1031.08,Credit,44145.52,,system,2025-06-08 17:17:13.605523,system,2025-06-08 17:17:13.605523
463abbdb15854ee7a004475c88a3aa00,796038a187fa417da4c1f62d6f39855c,2025-02-08,Here appear both model general blood.,3947.56,Credit,48093.08,,system,2025-06-08 17:17:13.605523,system,2025-06-08 17:17:13.605523
81942ab9dcb64ace99c0aa6feb3aa5bb,796038a187fa417da4c1f62d6f39855c,2025-01-26,Coach become country put.,978.16,Credit,49071.24,,system,2025-06-08 17:17:13.605523,system,2025-06-08 17:17:13.605523
d71195417dbf404a928f03fda9169eb9,796038a187fa417da4c1f62d6f39855c,2025-03-14,Per interest later interest per enough law.,1614.78,Credit,50686.02,,system,2025-06-08 17:17:13.605523,system,2025-06-08 17:17:13.605523
267f2050deda4e7dbd7df7977f37ed31,796038a187fa417da4c1f62d6f39855c,2024-12-31,Letter help politics man or.,2751.7,Credit,53437.72,,system,2025-06-08 17:17:13.605523,system,2025-06-08 17:17:13.605523
2c265baf0685475889baf6a228cc1eb9,796038a187fa417da4c1f62d6f39855c,2025-01-09,Yeah box box factor more ability.,-4538.59,Debit,48899.13,,system,2025-06-08 17:17:13.605523,system,2025-06-08 17:17:13.605523
036b166e68344e77a5e5b58f6d2394d5,796038a187fa417da4c1f62d6f39855c,2024-12-21,Would test authority same marriage.,-713.51,Debit,48185.62,,system,2025-06-08 17:17:13.605523,system,2025-06-08 17:17:13.605523
7c3312762e9c4b7dba4a21fe0468b801,796038a187fa417da4c1f62d6f39855c,2025-01-11,Military kid pay ask.,-1941.46,Debit,46244.16,,system,2025-06-08 17:17:13.605523,system,2025-06-08 17:17:13.605523
effb8b1838224ad4af9d7fbca4c6adeb,839bcd7037184ab38e78314eb87109ae,2025-05-05,Decade technology kid back central six throughout.,383.79,Credit,50383.79,,system,2025-06-08 17:17:13.605523,system,2025-06-08 17:17:13.605523
cf7a9646ac4b4ff397c1cc2c1ed0da30,839bcd7037184ab38e78314eb87109ae,2025-05-31,Attention statement play situation admit ago entire result.,1296.38,Credit,51680.17,,system,2025-06-08 17:17:13.605523,system,2025-06-08 17:17:13.605523
042328557fea4103b6a96939ada3291a,839bcd7037184ab38e78314eb87109ae,2025-01-03,Cup across soon man industry imagine later.,624.03,Credit,52304.2,,system,2025-06-08 17:17:13.605523,system,2025-06-08 17:17:13.605523
9945340d1d9e4893b0c17365331d9e31,839bcd7037184ab38e78314eb87109ae,2025-04-24,Reality green art shake wind increase.,1053.52,Credit,53357.72,,system,2025-06-08 17:17:13.605523,system,2025-06-08 17:17:13.605523
afb586ab91f3484c8318e990b3ed64a5,839bcd7037184ab38e78314eb87109ae,2025-02-11,Property image experience Democrat assume positive never.,2026.18,Credit,55383.9,,system,2025-06-08 17:17:13.605523,system,2025-06-08 17:17:13.605523
05787e5a4de14af784d29b192d60093b,839bcd7037184ab38e78314eb87109ae,2025-04-21,This possible both similar.,-165.45,Debit,55218.45,,system,2025-06-08 17:17:13.605523,system,2025-06-08 17:17:13.605523
de31b6ff041d49e897a5bc80ddadabd1,839bcd7037184ab38e78314eb87109ae,2025-05-16,Such throw middle culture.,-1713.78,Debit,53504.67,,system,2025-06-08 17:17:13.605523,system,2025-06-08 17:17:13.605523
fdc6ce3a6526476792aad189736cfcca,839bcd7037184ab38e78314eb87109ae,2025-01-29,Small poor production.,-814.63,Debit,52690.04,,system,2025-06-08 17:17:13.605523,system,2025-06-08 17:17:13.605523
ec3f7ca3924f4ed2960b7cd238fa417d,839bcd7037184ab38e78314eb87109ae,2025-04-17,Set may pressure five personal develop force.,-4356.28,Debit,48333.76,,system,2025-06-08 17:17:13.605523,system,2025-06-08 17:17:13.605523
16b79ade1eaa4fdabffb3a035ca3d567,839bcd7037184ab38e78314eb87109ae,2024-12-31,Fast may game lay.,-2842.07,Debit,45491.69,,system,2025-06-08 17:17:13.605523,system,2025-06-08 17:17:13.605523
f3c8a71852ae446397cbf496d447d659,ee2efb58255d4e498e66be029de102fd,2025-02-19,About agreement however safe Congress cover Democrat.,-295.31,Debit,49704.69,,system,2025-06-08 17:17:13.605523,system,2025-06-08 17:17:13.605523
119b9328c5f94ae88a4dcc6bb9979ad7,ee2efb58255d4e498e66be029de102fd,2025-02-06,Wide executive about fly little deal.,-471.79,Debit,49232.9,,system,2025-06-08 17:17:13.605523,system,2025-06-08 17:17:13.605523
71005189b2484bfc8273b57c2778106e,ee2efb58255d4e498e66be029de102fd,2025-05-09,Two popular morning open.,1924.11,Credit,51157.01,,system,2025-06-08 17:17:13.605523,system,2025-06-08 17:17:13.605523
f7f3560a545942e2ae65ae210340c7b2,ee2efb58255d4e498e66be029de102fd,2025-04-12,Entire this scientist school need offer.,-211.78,Debit,50945.23,,system,2025-06-08 17:17:13.605523,system,2025-06-08 17:17:13.605523
7f0c4cab31b74208a5bea7434007a5f2,ee2efb58255d4e498e66be029de102fd,2025-06-06,World evening later least.,2066.12,Credit,53011.35,,system,2025-06-08 17:17:13.605523,system,2025-06-08 17:17:13.605523
e7e41ac89458402fbb674786b31232c4,ee2efb58255d4e498e66be029de102fd,2025-04-23,Along detail their public language.,2063.47,Credit,55074.82,,system,2025-06-08 17:17:13.605523,system,2025-06-08 17:17:13.605523
0580a68aab0544b28aab8e940b3d68ef,ee2efb58255d4e498e66be029de102fd,2024-12-24,Knowledge establish who run cover.,-1943.7,Debit,53131.12,,system,2025-06-08 17:17:13.605523,system,2025-06-08 17:17:13.605523
d054a2f5b1d54776981203dfc54e015b,ee2efb58255d4e498e66be029de102fd,2025-04-26,South administration year race.,-3283.49,Debit,49847.63,,system,2025-06-08 17:17:13.605523,system,2025-06-08 17:17:13.605523
eb3370022f664318b0fa4a4e5ac59a78,ee2efb58255d4e498e66be029de102fd,2025-03-31,Maybe history involve discussion.,2349.75,Credit,52197.38,,system,2025-06-08 17:17:13.605523,system,2025-06-08 17:17:13.605523
85bdec1033734cbcb99e1b0554ad2c70,ee2efb58255d4e498e66be029de102fd,2025-01-02,Likely finally fish house summer medical everybody reach.,-4059.42,Debit,48137.96,,system,2025-06-08 17:17:13.605523,system,2025-06-08 17:17:13.605523
2b2a80a71a5c4978bb5562c1596953ec,6bf415c4987047d4a6b0dfb917f0a048,2025-04-11,Citizen security laugh course grow movie player serious.,252.11,Credit,50252.11,,system,2025-06-08 17:17:13.605523,system,2025-06-08 17:17:13.605523
eaa4cc17a1794dd8b36d650b7b749a0d,6bf415c4987047d4a6b0dfb917f0a048,2025-05-24,Law mouth camera spring wait religious race.,3107.58,Credit,53359.69,,system,2025-06-08 17:17:13.605523,system,2025-06-08 17:17:13.605523
bd1b008974664ff69655959c38217f49,6bf415c4987047d4a6b0dfb917f0a048,2025-04-07,Lose marriage sport section produce PM economic.,-882.05,Debit,52477.64,,system,2025-06-08 17:17:13.605523,system,2025-06-08 17:17:13.605523
dbc13be4f5a040ef89a7757d0e71e2ce,6bf415c4987047d4a6b0dfb917f0a048,2025-04-09,Set edge chair fight agree clearly.,-3151.73,Debit,49325.91,,system,2025-06-08 17:17:13.605523,system,2025-06-08 17:17:13.605523
33e80f40478b4a6aa884d1056455436f,6bf415c4987047d4a6b0dfb917f0a048,2025-03-22,Happen old activity similar organization administration bag couple.,-661.2,Debit,48664.71,,system,2025-06-08 17:17:13.605523,system,2025-06-08 17:17:13.605523
280f01d6cbae48c7abd4966210a7cc49,6bf415c4987047d4a6b0dfb917f0a048,2025-05-15,Recent school notice himself responsibility manager.,4017.87,Credit,52682.58,,system,2025-06-08 17:17:13.605523,system,2025-06-08 17:17:13.605523
e10f0c6d84864803ab0ba8b8bff7a4cd,6bf415c4987047d4a6b0dfb917f0a048,2025-05-14,Part maintain set left day interest.,3915.6,Credit,56598.18,,system,2025-06-08 17:17:13.605523,system,2025-06-08 17:17:13.605523
c0ee55d21cc1467b936f8b1bd24e3de3,6bf415c4987047d4a6b0dfb917f0a048,2025-03-21,True hope career still ok garden.,1488.14,Credit,58086.32,,system,2025-06-08 17:17:13.605523,system,2025-06-08 17:17:13.605523
f9cc709bc5334844bcc9516da90cbd10,6bf415c4987047d4a6b0dfb917f0a048,2025-04-26,Range matter street rate.,-2098.11,Debit,55988.21,,system,2025-06-08 17:17:13.605523,system,2025-06-08 17:17:13.605523
699e92fae9df458abf230fc26ad22fee,6bf415c4987047d4a6b0dfb917f0a048,2025-01-18,Final power military father old.,-2034.69,Debit,53953.52,,system,2025-06-08 17:17:13.605523,system,2025-06-08 17:17:13.605523
d78dd2efb8dc4a21aa3807e52918802e,0b7f944e96dc4197af860535227cc128,2025-03-31,As general husband main relate.,3726.15,Credit,53726.15,,system,2025-06-08 17:17:13.605523,system,2025-06-08 17:17:13.605523
c4f30a7028d84de0aec5fa4910054586,0b7f944e96dc4197af860535227cc128,2024-12-19,Lay traditional central not despite leader.,-3446.99,Debit,50279.16,,system,2025-06-08 17:17:13.605523,system,2025-06-08 17:17:13.605523
cbab92437263473c94ce49ba24b662db,0b7f944e96dc4197af860535227cc128,2024-12-13,Pick life worker staff think last.,-4691.83,Debit,45587.33,,system,2025-06-08 17:17:13.605523,system,2025-06-08 17:17:13.605523
543f8f8c1e4b4ebfacde632ba29ff914,0b7f944e96dc4197af860535227cc128,2025-03-06,People within cut because company.,-2204.89,Debit,43382.44,,system,2025-06-08 17:17:13.605523,system,2025-06-08 17:17:13.605523
8420acd1f35a4a86933ebdeeaa3c9ed8,0b7f944e96dc4197af860535227cc128,2025-01-06,Bad line door town form.,-4926.77,Debit,38455.67,,system,2025-06-08 17:17:13.605523,system,2025-06-08 17:17:13.605523
45475c5c480546cb85d56418699f64b0,0b7f944e96dc4197af860535227cc128,2025-02-23,Above recognize financial spend wish.,-1923.5,Debit,36532.17,,system,2025-06-08 17:17:13.605523,system,2025-06-08 17:17:13.605523
6069498c6e8e4589916ac7c6f11aa026,0b7f944e96dc4197af860535227cc128,2025-05-16,Future product successful recent ground policy trial player.,-1489.63,Debit,35042.54,,system,2025-06-08 17:17:13.605523,system,2025-06-08 17:17:13.605523
9f4897ccff8e4172a511b7dc2ac19e3b,0b7f944e96dc4197af860535227cc128,2025-01-28,Chair degree draw simply.,-3819.85,Debit,31222.69,,system,2025-06-08 17:17:13.605523,system,2025-06-08 17:17:13.605523
55008123d6914189b82ee0281a770ce7,0b7f944e96dc4197af860535227cc128,2025-05-23,Ready black break prevent miss maintain decision.,-742.03,Debit,30480.66,,system,2025-06-08 17:17:13.605523,system,2025-06-08 17:17:13.605523
b3141b1ad5d347068fc5ee2ba039e21c,0b7f944e96dc4197af860535227cc128,2025-02-22,Third six fine lawyer alone.,4798.75,Credit,35279.41,,system,2025-06-08 17:17:13.605523,system,2025-06-08 17:17:13.605523
511763a12ed646d99148360eac4e247d,a817676cf377463db2a227c80bc972b6,2025-06-06,Debate simple matter buy.,4896.93,Credit,54896.93,,system,2025-06-08 17:17:13.605523,system,2025-06-08 17:17:13.605523
ce37096f956b450cae1df9e039b86f6c,a817676cf377463db2a227c80bc972b6,2025-01-12,Well PM treatment.,1126.89,Credit,56023.82,,system,2025-06-08 17:17:13.605523,system,2025-06-08 17:17:13.605523
d58d73da08f045e885432277ade52ae1,a817676cf377463db2a227c80bc972b6,2025-03-21,Simple oil act dream.,-2149.93,Debit,53873.89,,system,2025-06-08 17:17:13.605523,system,2025-06-08 17:17:13.605523
5e4c975c8bad4ff0a38c3d18b1414540,a817676cf377463db2a227c80bc972b6,2025-04-20,Address nice politics spend federal agency.,-50.07,Debit,53823.82,,system,2025-06-08 17:17:13.605523,system,2025-06-08 17:17:13.605523
53f6132f1d5747ca942374e88eab417f,a817676cf377463db2a227c80bc972b6,2025-01-01,Wait cost support.,1209.97,Credit,55033.79,,system,2025-06-08 17:17:13.605523,system,2025-06-08 17:17:13.605523
0543a5fcd5374461ace69494f7ee7978,a817676cf377463db2a227c80bc972b6,2025-04-20,Range to prove.,2066.81,Credit,57100.6,,system,2025-06-08 17:17:13.605523,system,2025-06-08 17:17:13.605523
83fc9f05d5984659a32e91db098150b5,a817676cf377463db2a227c80bc972b6,2025-03-19,Capital happy event fact.,-325.42,Debit,56775.18,,system,2025-06-08 17:17:13.605523,system,2025-06-08 17:17:13.605523
407968159aa64df69b771e820431e621,a817676cf377463db2a227c80bc972b6,2024-12-28,Occur medical baby all conference today style general.,-1889.54,Debit,54885.64,,system,2025-06-08 17:17:13.605523,system,2025-06-08 17:17:13.605523
a28235221bbc4182a3e31f63268f76c8,a817676cf377463db2a227c80bc972b6,2025-03-17,Role amount impact board leave four.,-3657.65,Debit,51227.99,,system,2025-06-08 17:17:13.605523,system,2025-06-08 17:17:13.605523
1d1868085dea4283b583e4686625655e,a817676cf377463db2a227c80bc972b6,2024-12-15,There adult believe specific.,4901.18,Credit,56129.17,,system,2025-06-08 17:17:13.605523,system,2025-06-08 17:17:13.605523
126d5c1505194e25ad4b8d1881309925,c5e81ba50fc84bf89ef18b1e60467f8b,2025-05-25,Knowledge fight surface before threat involve provide.,1334.38,Credit,51334.38,,system,2025-06-08 17:17:13.605523,system,2025-06-08 17:17:13.605523
8762f3bb79264a49bf7dc83721c6e887,c5e81ba50fc84bf89ef18b1e60467f8b,2025-04-24,Shoulder rock first feeling.,85.71,Credit,51420.09,,system,2025-06-08 17:17:13.605523,system,2025-06-08 17:17:13.605523
7fb0a093e5cb44fc9ac1c4676220bff2,c5e81ba50fc84bf89ef18b1e60467f8b,2025-05-20,First wonder issue meeting remain.,-1144.56,Debit,50275.53,,system,2025-06-08 17:17:13.605523,system,2025-06-08 17:17:13.605523
3961ef1ebd8042c7a8ee4723ded03cf5,c5e81ba50fc84bf89ef18b1e60467f8b,2025-05-21,Major create notice ahead.,1673.97,Credit,51949.5,,system,2025-06-08 17:17:13.605523,system,2025-06-08 17:17:13.605523
8c63246748c94af985f1a5dba189301d,c5e81ba50fc84bf89ef18b1e60467f8b,2025-04-18,Tree station him dark hear.,-4728.39,Debit,47221.11,,system,2025-06-08 17:17:13.605523,system,2025-06-08 17:17:13.605523
16923a862a6e46d89abc7875efaa481b,c5e81ba50fc84bf89ef18b1e60467f8b,2025-03-19,Buy skill we central war perhaps interview.,-1816.94,Debit,45404.17,,system,2025-06-08 17:17:13.605523,system,2025-06-08 17:17:13.605523
d71b76d3e8d84db7846650f6820870b8,c5e81ba50fc84bf89ef18b1e60467f8b,2025-04-23,Left example successful save blue keep.,1165.03,Credit,46569.2,,system,2025-06-08 17:17:13.605523,system,2025-06-08 17:17:13.605523
1554cf20e29f4b0896c9331e9edebe46,c5e81ba50fc84bf89ef18b1e60467f8b,2025-01-08,Maybe yard prevent opportunity receive large fund or.,2493.49,Credit,49062.69,,system,2025-06-08 17:17:13.605523,system,2025-06-08 17:17:13.605523
b883bb57a4bc47039274321f0dd1dbc6,c5e81ba50fc84bf89ef18b1e60467f8b,2025-05-30,Shoulder information front year kind board.,4900.77,Credit,53963.46,,system,2025-06-08 17:17:13.605523,system,2025-06-08 17:17:13.605523
6445d9b28c0b44408a727174452034cf,c5e81ba50fc84bf89ef18b1e60467f8b,2025-04-25,Bad case something great let.,1341.73,Credit,55305.19,,system,2025-06-08 17:17:13.605523,system,2025-06-08 17:17:13.605523
f217477ee24243dfac7b559e096fa563,7e49038ead91463583acb7c12931bd64,2025-03-03,Modern impact media report.,-2581.38,Debit,47418.62,,system,2025-06-08 17:17:13.605523,system,2025-06-08 17:17:13.605523
99e6c197504e40cebe7ff3b5979b14f4,7e49038ead91463583acb7c12931bd64,2025-02-18,Several force yes about even spring.,2111.25,Credit,49529.87,,system,2025-06-08 17:17:13.605523,system,2025-06-08 17:17:13.605523
85393343bbbe4a87974d993df0269d1a,7e49038ead91463583acb7c12931bd64,2025-02-20,Tend recent rich four crime scene night.,830.86,Credit,50360.73,,system,2025-06-08 17:17:13.605523,system,2025-06-08 17:17:13.605523
7a2e99e34fe24fb589025de4041e216b,7e49038ead91463583acb7c12931bd64,2025-04-27,Hour hope his themselves account high thank.,999.48,Credit,51360.21,,system,2025-06-08 17:17:13.605523,system,2025-06-08 17:17:13.605523
e90048a2391c4b8a93705e790ed90a52,7e49038ead91463583acb7c12931bd64,2025-04-10,Sing offer around.,698.47,Credit,52058.68,,system,2025-06-08 17:17:13.605523,system,2025-06-08 17:17:13.605523
2a3a937de8f84053a1ac810896438c30,7e49038ead91463583acb7c12931bd64,2025-03-02,Either than off authority.,-2682.87,Debit,49375.81,,system,2025-06-08 17:17:13.605523,system,2025-06-08 17:17:13.605523
5fb2106d99d041169d58275ae37fece8,7e49038ead91463583acb7c12931bd64,2025-04-05,Help generation daughter.,-4067.29,Debit,45308.52,,system,2025-06-08 17:17:13.605523,system,2025-06-08 17:17:13.605523
b30fa58e2ea04cce97d9709f05266622,7e49038ead91463583acb7c12931bd64,2025-05-23,Themselves cultural him business control individual.,-4071.35,Debit,41237.17,,system,2025-06-08 17:17:13.605523,system,2025-06-08 17:17:13.605523
c5e8d14564374401bbdbdee8a6e6317b,7e49038ead91463583acb7c12931bd64,2025-01-21,Like well authority enjoy player then subject.,1251.13,Credit,42488.3,,system,2025-06-08 17:17:13.605523,system,2025-06-08 17:17:13.605523
272499404055402fad4f13cfee776a4b,7e49038ead91463583acb7c12931bd64,2025-04-20,Knowledge mind day evening.,2824.36,Credit,45312.66,,system,2025-06-08 17:17:13.605523,system,2025-06-08 17:17:13.605523
74545e00fb9549a5baeadde4fcb86e05,e52c45759964471d931f3197b4ce1c74,2025-06-04,Future part apply put head everybody phone.,1088.3,Credit,51088.3,,system,2025-06-08 17:17:13.605523,system,2025-06-08 17:17:13.605523
7ac2526b641542a3b3fccf44b8554dc9,e52c45759964471d931f3197b4ce1c74,2025-04-10,Off national law go long institution system.,3357.75,Credit,54446.05,,system,2025-06-08 17:17:13.605523,system,2025-06-08 17:17:13.605523
7f499e48a1864d26b1babff1f38e38ca,e52c45759964471d931f3197b4ce1c74,2025-03-22,From you build why wall medical religious.,2834.42,Credit,57280.47,,system,2025-06-08 17:17:13.605523,system,2025-06-08 17:17:13.605523
739619553d98485cae5e7a81f42d1111,e52c45759964471d931f3197b4ce1c74,2024-12-23,One health all small admit serious.,-3731.83,Debit,53548.64,,system,2025-06-08 17:17:13.605523,system,2025-06-08 17:17:13.605523
fbe1b1d63a8e4a58ab341e350b78d2ef,e52c45759964471d931f3197b4ce1c74,2025-05-01,Even everything interview baby cold affect.,1309.26,Credit,54857.9,,system,2025-06-08 17:17:13.605523,system,2025-06-08 17:17:13.605523
602c1e460294446199fb556ca10564af,e52c45759964471d931f3197b4ce1c74,2025-03-04,Phone network mean attorney many water.,-2059.44,Debit,52798.46,,system,2025-06-08 17:17:13.605523,system,2025-06-08 17:17:13.605523
dd7e9c0dfba249079a39e0b0c75b4241,e52c45759964471d931f3197b4ce1c74,2025-04-24,Thousand the ok how sound operation hospital.,-753.6,Debit,52044.86,,system,2025-06-08 17:17:13.605523,system,2025-06-08 17:17:13.605523
889b6222debc46f69effaff7daf9f2ff,e52c45759964471d931f3197b4ce1c74,2025-04-21,Use grow happen know.,123.87,Credit,52168.73,,system,2025-06-08 17:17:13.605523,system,2025-06-08 17:17:13.605523
748324edb2dc41e0b6e5290609aa04e6,e52c45759964471d931f3197b4ce1c74,2025-04-21,Serve debate left send pass back effect.,-2298.41,Debit,49870.32,,system,2025-06-08 17:17:13.605523,system,2025-06-08 17:17:13.605523
6ea6d700d7aa412899fc61118048897d,e52c45759964471d931f3197b4ce1c74,2025-03-24,Forget memory here again others easy reduce.,-2984.28,Debit,46886.04,,system,2025-06-08 17:17:13.605523,system,2025-06-08 17:17:13.605523
6951c95d7b2f4b458978bacee8deb303,fc5ac013d7fa4a1aa2c105a91c09c7da,2025-01-22,Offer him leave ground region recently me.,1745.46,Credit,51745.46,,system,2025-06-08 17:17:13.605523,system,2025-06-08 17:17:13.605523
b03d0cd6de89465797578f1656de193d,fc5ac013d7fa4a1aa2c105a91c09c7da,2025-04-09,Building meet keep and.,1045.08,Credit,52790.54,,system,2025-06-08 17:17:13.605523,system,2025-06-08 17:17:13.605523
f381f33eb8244fdcbb29920eb57b61f0,fc5ac013d7fa4a1aa2c105a91c09c7da,2025-02-08,So large region growth article son the.,-2426.46,Debit,50364.08,,system,2025-06-08 17:17:13.605523,system,2025-06-08 17:17:13.605523
93877f68da5349fc930a59b8944b3eb1,fc5ac013d7fa4a1aa2c105a91c09c7da,2025-01-25,Bring than music third indicate put leg.,-1290.73,Debit,49073.35,,system,2025-06-08 17:17:13.605523,system,2025-06-08 17:17:13.605523
dc62fd24efd24acf9d8309b71c2c505d,fc5ac013d7fa4a1aa2c105a91c09c7da,2025-01-03,Day company reduce.,-1187.51,Debit,47885.84,,system,2025-06-08 17:17:13.605523,system,2025-06-08 17:17:13.605523
b1662326559f41fd9eca68f318aa4c7c,fc5ac013d7fa4a1aa2c105a91c09c7da,2025-05-30,Send believe traditional.,-2455.98,Debit,45429.86,,system,2025-06-08 17:17:13.605523,system,2025-06-08 17:17:13.605523
c8c962a90aad4896a47c39d81c7abefa,fc5ac013d7fa4a1aa2c105a91c09c7da,2025-03-08,Be check response write.,77.3,Credit,45507.16,,system,2025-06-08 17:17:13.605523,system,2025-06-08 17:17:13.605523
e657c7281da34246b7ca1412ab0732f0,fc5ac013d7fa4a1aa2c105a91c09c7da,2025-04-25,Rest arm not hard so.,3119.35,Credit,48626.51,,system,2025-06-08 17:17:13.605523,system,2025-06-08 17:17:13.605523
8b94054be52c430da70233095d3a4434,fc5ac013d7fa4a1aa2c105a91c09c7da,2025-01-16,Mouth like need because TV.,-2157.21,Debit,46469.3,,system,2025-06-08 17:17:13.605523,system,2025-06-08 17:17:13.605523
c2ecd322b34e45b1bda726aeafc5a334,fc5ac013d7fa4a1aa2c105a91c09c7da,2025-01-01,Stage need arm fly occur present animal.,-3234.05,Debit,43235.25,,system,2025-06-08 17:17:13.605523,system,2025-06-08 17:17:13.605523
d0748395b3124e038aa124250e9bf638,e15eeb65dfe740bda1e16c2fcdc4e95b,2025-01-18,Ahead difficult long.,4447.14,Credit,54447.14,,system,2025-06-08 17:17:13.605523,system,2025-06-08 17:17:13.605523
c1bb12cb220d478596a37be4eecccbf1,e15eeb65dfe740bda1e16c2fcdc4e95b,2025-06-03,Improve myself specific into.,-1702.31,Debit,52744.83,,system,2025-06-08 17:17:13.605523,system,2025-06-08 17:17:13.605523
0a1334b8fb874fd3bebfbc79085dc472,e15eeb65dfe740bda1e16c2fcdc4e95b,2025-04-17,Research radio thought manager toward.,-502.33,Debit,52242.5,,system,2025-06-08 17:17:13.605523,system,2025-06-08 17:17:13.605523
e6c7e8a50b7d4e3ebe99fe41608a7452,e15eeb65dfe740bda1e16c2fcdc4e95b,2025-06-03,Once manager inside huge Republican business.,-1599.74,Debit,50642.76,,system,2025-06-08 17:17:13.620533,system,2025-06-08 17:17:13.620533
9bf6dd98b11b49f98f30080d40cc1522,e15eeb65dfe740bda1e16c2fcdc4e95b,2025-03-12,Television pattern nice century.,776.18,Credit,51418.94,,system,2025-06-08 17:17:13.620533,system,2025-06-08 17:17:13.620533
cb7f503da3dc48aaa879c3142734fe2b,e15eeb65dfe740bda1e16c2fcdc4e95b,2025-01-16,Administration suggest rock guess professor image say.,-3369.11,Debit,48049.83,,system,2025-06-08 17:17:13.620533,system,2025-06-08 17:17:13.620533
637be2840fec4f9bb103e48e514ed653,e15eeb65dfe740bda1e16c2fcdc4e95b,2025-01-26,Government provide week stop enjoy every Mrs.,1336.02,Credit,49385.85,,system,2025-06-08 17:17:13.620533,system,2025-06-08 17:17:13.620533
6799682c29234a78976a838cee1bf332,e15eeb65dfe740bda1e16c2fcdc4e95b,2025-03-05,Tv back go environment stay.,3069.61,Credit,52455.46,,system,2025-06-08 17:17:13.620533,system,2025-06-08 17:17:13.620533
586e21f68f2a4652985c314bd593b47f,e15eeb65dfe740bda1e16c2fcdc4e95b,2025-02-06,Company place share share represent.,1087.79,Credit,53543.25,,system,2025-06-08 17:17:13.620533,system,2025-06-08 17:17:13.620533
88966f2b01444b1a97906fea25dba4ec,e15eeb65dfe740bda1e16c2fcdc4e95b,2025-06-06,Baby say similar follow other.,3435.28,Credit,56978.53,,system,2025-06-08 17:17:13.620533,system,2025-06-08 17:17:13.620533
a7066f3b43b0456c8ee2c043ba61c30f,ae68d206937b41b195701a98597b61f3,2025-02-19,Still party most of hot sense cover.,-2512.61,Debit,47487.39,,system,2025-06-08 17:17:13.620533,system,2025-06-08 17:17:13.620533
621445c56f324638b46e3e3f0fe515f4,ae68d206937b41b195701a98597b61f3,2025-01-05,Fast senior no compare.,3066.69,Credit,50554.08,,system,2025-06-08 17:17:13.620533,system,2025-06-08 17:17:13.620533
f8f3f73188e54c718be4ab658b4a449c,ae68d206937b41b195701a98597b61f3,2025-02-20,Specific every financial mother end.,3736.25,Credit,54290.33,,system,2025-06-08 17:17:13.620533,system,2025-06-08 17:17:13.620533
7425820433c64d629c52efd1bff87a88,ae68d206937b41b195701a98597b61f3,2025-04-16,Economic ground economic describe.,-2166.21,Debit,52124.12,,system,2025-06-08 17:17:13.620533,system,2025-06-08 17:17:13.620533
d9045e136fec49108a60620ffeaeca67,ae68d206937b41b195701a98597b61f3,2025-05-15,Other well money card catch.,-1772.84,Debit,50351.28,,system,2025-06-08 17:17:13.620533,system,2025-06-08 17:17:13.620533
76b92e9a54ae4a719d424b1b26a4c7d2,ae68d206937b41b195701a98597b61f3,2025-02-08,Mrs read pretty window stay.,3395.07,Credit,53746.35,,system,2025-06-08 17:17:13.620533,system,2025-06-08 17:17:13.620533
6e234ffdc36a44f4b0828a0b187c49b6,ae68d206937b41b195701a98597b61f3,2025-05-28,Control while chair front save another.,-951.42,Debit,52794.93,,system,2025-06-08 17:17:13.621041,system,2025-06-08 17:17:13.621041
9586c53c11b54b5da8a28e409579c62d,ae68d206937b41b195701a98597b61f3,2025-05-08,Paper past happy control.,-2413.86,Debit,50381.07,,system,2025-06-08 17:17:13.621041,system,2025-06-08 17:17:13.621041
9640d3bd5e60453abc13f914c6522685,ae68d206937b41b195701a98597b61f3,2025-01-26,Politics situation military measure member.,3025.68,Credit,53406.75,,system,2025-06-08 17:17:13.621041,system,2025-06-08 17:17:13.621041
3df3966855cb45bb8ee54360663267a6,ae68d206937b41b195701a98597b61f3,2025-05-30,Name economic summer official present authority mouth.,-2985.91,Debit,50420.84,,system,2025-06-08 17:17:13.621041,system,2025-06-08 17:17:13.621041
5c2698ba56614940a900053ea18ae32f,23ad79cf60ac441b92e81665cdab2f7a,2025-01-09,Meeting four story.,2620.22,Credit,52620.22,,system,2025-06-08 17:17:13.621041,system,2025-06-08 17:17:13.621041
41fb1621b54845478f568ad669ef0086,23ad79cf60ac441b92e81665cdab2f7a,2025-05-05,Feeling understand understand language agree.,-1597.77,Debit,51022.45,,system,2025-06-08 17:17:13.621041,system,2025-06-08 17:17:13.621041
ab95ea6cbd2f4447b5b2f8de6cb7a3ae,23ad79cf60ac441b92e81665cdab2f7a,2025-02-12,Prepare number feeling.,504.79,Credit,51527.24,,system,2025-06-08 17:17:13.621041,system,2025-06-08 17:17:13.621041
50503c2d59e34800b6270f41263b3c9f,23ad79cf60ac441b92e81665cdab2f7a,2025-03-30,Natural trade vote purpose side guess and better.,-2877.33,Debit,48649.91,,system,2025-06-08 17:17:13.621041,system,2025-06-08 17:17:13.621041
64010512609840b789d7937c8c23b95e,23ad79cf60ac441b92e81665cdab2f7a,2025-01-03,Family near whose everyone.,4859.55,Credit,53509.46,,system,2025-06-08 17:17:13.621041,system,2025-06-08 17:17:13.621041
4af4e6a2a4684c10941ea221e4a14026,23ad79cf60ac441b92e81665cdab2f7a,2024-12-20,Assume will above story oil investment our.,1450.56,Credit,54960.02,,system,2025-06-08 17:17:13.621041,system,2025-06-08 17:17:13.621041
269ce4b97b7e4cc5b7c124cecb62381a,23ad79cf60ac441b92e81665cdab2f7a,2025-02-17,Everyone tough first.,-1227.09,Debit,53732.93,,system,2025-06-08 17:17:13.621041,system,2025-06-08 17:17:13.621041
f6229ce1dc424c6eadbbf5c9f77fa90e,23ad79cf60ac441b92e81665cdab2f7a,2025-01-09,Let month style fast culture stop.,-703.01,Debit,53029.92,,system,2025-06-08 17:17:13.621041,system,2025-06-08 17:17:13.621041
b6d73b2ee0554678bfe83174619cc252,23ad79cf60ac441b92e81665cdab2f7a,2025-01-11,Force religious form television bank reason address.,388.94,Credit,53418.86,,system,2025-06-08 17:17:13.621041,system,2025-06-08 17:17:13.621041
45d0e34c8796478eaf7406ce1e316ec8,23ad79cf60ac441b92e81665cdab2f7a,2025-06-04,Four politics purpose piece whom.,-2417.86,Debit,51001.0,,system,2025-06-08 17:17:13.621041,system,2025-06-08 17:17:13.621041
797e8850e4324e8a8dd987402ddaa07e,f705315ef39b4f1aa2837cd26bf3409c,2025-05-12,Region politics actually cover.,-914.17,Debit,49085.83,,system,2025-06-08 17:17:13.621041,system,2025-06-08 17:17:13.621041
ebc65d2eff404e9b9ad7c8f1631429eb,f705315ef39b4f1aa2837cd26bf3409c,2024-12-26,Serve require knowledge explain.,-424.24,Debit,48661.59,,system,2025-06-08 17:17:13.621041,system,2025-06-08 17:17:13.621041
86025451bd5f47eaac48a42e3dc60980,f705315ef39b4f1aa2837cd26bf3409c,2025-02-18,Near place agreement able.,-4777.51,Debit,43884.08,,system,2025-06-08 17:17:13.621041,system,2025-06-08 17:17:13.621041
40ca2919fdd84fb5bb806ddd4b654d9e,f705315ef39b4f1aa2837cd26bf3409c,2025-05-18,Lawyer usually able central.,842.42,Credit,44726.5,,system,2025-06-08 17:17:13.621041,system,2025-06-08 17:17:13.621041
e21c119710934375851dab03717b5ae7,f705315ef39b4f1aa2837cd26bf3409c,2024-12-31,Wear course social note.,3462.79,Credit,48189.29,,system,2025-06-08 17:17:13.621041,system,2025-06-08 17:17:13.621041
aa823cc31b80472096e1b28431aaee68,f705315ef39b4f1aa2837cd26bf3409c,2025-05-18,May speech life.,-596.85,Debit,47592.44,,system,2025-06-08 17:17:13.621041,system,2025-06-08 17:17:13.621041
b913f02058364260b8921b63d647a3f4,f705315ef39b4f1aa2837cd26bf3409c,2025-04-14,Executive loss science doctor claim.,-4192.06,Debit,43400.38,,system,2025-06-08 17:17:13.621041,system,2025-06-08 17:17:13.621041
4ca774e3c2634dea82ee51f11077e226,f705315ef39b4f1aa2837cd26bf3409c,2025-04-03,Turn manager laugh away thousand dream.,2984.21,Credit,46384.59,,system,2025-06-08 17:17:13.621041,system,2025-06-08 17:17:13.621041
1a6bb9cd6ae543b2b979b569227c080b,f705315ef39b4f1aa2837cd26bf3409c,2025-02-14,Nature a high follow town thing.,2961.18,Credit,49345.77,,system,2025-06-08 17:17:13.621041,system,2025-06-08 17:17:13.621041
822181bc4725480899d2816b5ff74b87,f705315ef39b4f1aa2837cd26bf3409c,2025-02-28,Themselves agreement key card card.,-3973.71,Debit,45372.06,,system,2025-06-08 17:17:13.621041,system,2025-06-08 17:17:13.621041
5f7e5b88649347149199e89b4f715103,d13dd7940a1940d289efd256e6052eed,2025-03-09,Road along child green body final who four.,-195.66,Debit,49804.34,,system,2025-06-08 17:17:13.621041,system,2025-06-08 17:17:13.621041
5c89970b59104a3abd1e857d8e60b081,d13dd7940a1940d289efd256e6052eed,2025-03-17,Pattern not reveal act here father.,-811.69,Debit,48992.65,,system,2025-06-08 17:17:13.621041,system,2025-06-08 17:17:13.621041
289655ac43a949ac8ced8ba26c4bff14,d13dd7940a1940d289efd256e6052eed,2025-03-14,Which their southern say road skill seven.,-4999.48,Debit,43993.17,,system,2025-06-08 17:17:13.621041,system,2025-06-08 17:17:13.621041
eb82699482bc4e77baa6ec77395a0c01,d13dd7940a1940d289efd256e6052eed,2025-01-30,Tonight claim social soldier.,-4234.26,Debit,39758.91,,system,2025-06-08 17:17:13.621041,system,2025-06-08 17:17:13.621041
b5da3eee63064128a42df06a0f2ff7f0,d13dd7940a1940d289efd256e6052eed,2025-06-03,Play service ten.,-776.23,Debit,38982.68,,system,2025-06-08 17:17:13.621041,system,2025-06-08 17:17:13.621041
6e059554c6e0458ea37dfb42b3c0b1cc,d13dd7940a1940d289efd256e6052eed,2025-03-02,Current cell herself reality.,1862.25,Credit,40844.93,,system,2025-06-08 17:17:13.621041,system,2025-06-08 17:17:13.621041
254ad47f25034b4781a0245797da106e,d13dd7940a1940d289efd256e6052eed,2025-03-26,Piece water network stage cost continue fine people.,-86.05,Debit,40758.88,,system,2025-06-08 17:17:13.621041,system,2025-06-08 17:17:13.621041
ef6aa8a3015c4848a70aea2bb19f9ffc,d13dd7940a1940d289efd256e6052eed,2024-12-16,Chance law offer government agency level family game.,-2392.41,Debit,38366.47,,system,2025-06-08 17:17:13.621041,system,2025-06-08 17:17:13.621041
673adfcdc7f041b79d6721460b2f9c8d,d13dd7940a1940d289efd256e6052eed,2025-03-28,Debate case describe right.,-3192.98,Debit,35173.49,,system,2025-06-08 17:17:13.621041,system,2025-06-08 17:17:13.621041
754c875487b84c2897180c24574c0e74,d13dd7940a1940d289efd256e6052eed,2025-03-06,Believe TV attack might nature.,1942.94,Credit,37116.43,,system,2025-06-08 17:17:13.621041,system,2025-06-08 17:17:13.621041
283c79feda254326b6df60a3bea93af8,2a2007ca07aa4a85a9983e93a944ad67,2024-12-27,Information value him stage.,1106.96,Credit,51106.96,,system,2025-06-08 17:17:13.621041,system,2025-06-08 17:17:13.621041
f1e475244f5f4d41a64a5e20d1e475f0,2a2007ca07aa4a85a9983e93a944ad67,2025-01-12,Sing man moment prove drop.,4833.83,Credit,55940.79,,system,2025-06-08 17:17:13.621041,system,2025-06-08 17:17:13.621041
5fe366af2b94431585ae63a559555e15,2a2007ca07aa4a85a9983e93a944ad67,2025-06-04,Per fear office from after parent suffer.,171.23,Credit,56112.02,,system,2025-06-08 17:17:13.621041,system,2025-06-08 17:17:13.621041
efae6b641c204b8b811922fe4835d776,2a2007ca07aa4a85a9983e93a944ad67,2025-03-29,Movie bed system crime.,3829.43,Credit,59941.45,,system,2025-06-08 17:17:13.621041,system,2025-06-08 17:17:13.621041
9ffd00db52f4495a8b4d4e624c5e159c,2a2007ca07aa4a85a9983e93a944ad67,2025-06-04,Sort themselves beyond discover season eat.,-1757.95,Debit,58183.5,,system,2025-06-08 17:17:13.621041,system,2025-06-08 17:17:13.621041
0bc880828d9542709cf1188354b949c4,2a2007ca07aa4a85a9983e93a944ad67,2025-02-24,Condition attorney quality.,1457.13,Credit,59640.63,,system,2025-06-08 17:17:13.621041,system,2025-06-08 17:17:13.621041
fb4917c13dba4ce9a5fbdb370c52c2d3,2a2007ca07aa4a85a9983e93a944ad67,2025-01-12,Final hundred several very later stock.,-914.72,Debit,58725.91,,system,2025-06-08 17:17:13.621041,system,2025-06-08 17:17:13.621041
7f14afad787c4205b6dd8a0bd638c617,2a2007ca07aa4a85a9983e93a944ad67,2025-04-11,Personal follow message this yet national should.,2909.88,Credit,61635.79,,system,2025-06-08 17:17:13.621041,system,2025-06-08 17:17:13.621041
109aba2a8aca4b9cb853679c00a171cb,2a2007ca07aa4a85a9983e93a944ad67,2025-03-21,Along PM find letter.,-155.27,Debit,61480.52,,system,2025-06-08 17:17:13.621041,system,2025-06-08 17:17:13.621041
22a3b62b17264ba9b089890956ab7fe7,2a2007ca07aa4a85a9983e93a944ad67,2025-04-02,Them hard save guy.,-4544.39,Debit,56936.13,,system,2025-06-08 17:17:13.621041,system,2025-06-08 17:17:13.621041
d220538c21494a59bbff1a0f7c5a3147,f18f5559b0e540d3acdde4429e41219c,2025-01-16,Always happy why bar to.,4012.41,Credit,54012.41,,system,2025-06-08 17:17:13.621041,system,2025-06-08 17:17:13.621041
5d3c3a4ca2a1458aad487bd8896e094d,f18f5559b0e540d3acdde4429e41219c,2025-02-08,Reach than police mouth friend.,-653.66,Debit,53358.75,,system,2025-06-08 17:17:13.621041,system,2025-06-08 17:17:13.621041
e33c93b3c3354f7fa8c6300b077c1445,f18f5559b0e540d3acdde4429e41219c,2025-01-22,Market along call.,3314.39,Credit,56673.14,,system,2025-06-08 17:17:13.621041,system,2025-06-08 17:17:13.621041
c147704108064c8ebd21dcb53b9b836d,f18f5559b0e540d3acdde4429e41219c,2025-03-16,Though body save one risk off traditional.,878.27,Credit,57551.41,,system,2025-06-08 17:17:13.621041,system,2025-06-08 17:17:13.621041
f6849ec355964feb89a3e5ed4e156c86,f18f5559b0e540d3acdde4429e41219c,2025-05-08,Pm go million camera from week.,3015.37,Credit,60566.78,,system,2025-06-08 17:17:13.621041,system,2025-06-08 17:17:13.621041
13e4248fb99d447a8610740905a16723,f18f5559b0e540d3acdde4429e41219c,2025-05-31,Already question open candidate think data guy bit.,-1993.37,Debit,58573.41,,system,2025-06-08 17:17:13.621041,system,2025-06-08 17:17:13.621041
c56f70e5f93c47ac99d6f3dd1174834d,f18f5559b0e540d3acdde4429e41219c,2025-03-16,Else benefit less approach hard huge process.,3444.84,Credit,62018.25,,system,2025-06-08 17:17:13.621041,system,2025-06-08 17:17:13.621041
95094667424d49fcad34b71a719599d6,f18f5559b0e540d3acdde4429e41219c,2024-12-16,Your national spring important production agency.,-4443.03,Debit,57575.22,,system,2025-06-08 17:17:13.621041,system,2025-06-08 17:17:13.621041
198a0f7ad0c0474a9d85416e14f59611,f18f5559b0e540d3acdde4429e41219c,2025-01-22,Give choice loss heavy population.,3592.65,Credit,61167.87,,system,2025-06-08 17:17:13.621041,system,2025-06-08 17:17:13.621041
f0443a5ffdfc41babf8f7886a32ceed1,f18f5559b0e540d3acdde4429e41219c,2024-12-10,Decade everybody stuff manager.,-1762.74,Debit,59405.13,,system,2025-06-08 17:17:13.621041,system,2025-06-08 17:17:13.621041
9bc762e38f9e4d22bbfb49f52b251f48,dad96fd0cbd54c8d9d8ae11688b62323,2025-02-19,Air instead any how best.,4989.92,Credit,54989.92,,system,2025-06-08 17:17:13.621041,system,2025-06-08 17:17:13.621041
7e81831f2eac443e8227ded22fe1e154,dad96fd0cbd54c8d9d8ae11688b62323,2025-03-04,Might action source late class participant pretty.,2445.68,Credit,57435.6,,system,2025-06-08 17:17:13.621041,system,2025-06-08 17:17:13.621041
54a66898bf814c5db67673636441a948,dad96fd0cbd54c8d9d8ae11688b62323,2025-03-23,Every part spend theory.,3745.44,Credit,61181.04,,system,2025-06-08 17:17:13.621041,system,2025-06-08 17:17:13.621041
1f94582821c7486ca481e190eabe6fdf,dad96fd0cbd54c8d9d8ae11688b62323,2025-05-21,Ability option the security.,141.62,Credit,61322.66,,system,2025-06-08 17:17:13.621041,system,2025-06-08 17:17:13.621041
6ff8021700194e63994eb042c8f039bf,dad96fd0cbd54c8d9d8ae11688b62323,2025-04-06,Team form lawyer remember.,1291.85,Credit,62614.51,,system,2025-06-08 17:17:13.621041,system,2025-06-08 17:17:13.621041
826d7bcb7d4c49f084196dfef6137d75,dad96fd0cbd54c8d9d8ae11688b62323,2025-03-27,Medical wish drug.,173.02,Credit,62787.53,,system,2025-06-08 17:17:13.621041,system,2025-06-08 17:17:13.621041
54b453989ab5479b85d910d5c3269adc,dad96fd0cbd54c8d9d8ae11688b62323,2025-02-24,Simply at recently somebody.,729.7,Credit,63517.23,,system,2025-06-08 17:17:13.621041,system,2025-06-08 17:17:13.621041
4c92595b65214e7391e51bbfd21dd9c6,dad96fd0cbd54c8d9d8ae11688b62323,2025-05-26,Voice design concern item close wonder.,3594.51,Credit,67111.74,,system,2025-06-08 17:17:13.621041,system,2025-06-08 17:17:13.621041
827bb9be795949f0aab14531d35374a0,dad96fd0cbd54c8d9d8ae11688b62323,2025-04-19,Sea that several strategy leave happy town stop.,1711.73,Credit,68823.47,,system,2025-06-08 17:17:13.621041,system,2025-06-08 17:17:13.621041
9e2278fe21284bea853075ca5a940dac,dad96fd0cbd54c8d9d8ae11688b62323,2025-03-11,Whom picture front one former.,-1769.24,Debit,67054.23,,system,2025-06-08 17:17:13.621041,system,2025-06-08 17:17:13.621041
da41073d09ee4363b5e5edefdfa731c0,7621aee19cf24e839beb7697bdf2946d,2025-05-18,Opportunity fight skin.,-2792.65,Debit,47207.35,,system,2025-06-08 17:17:13.621041,system,2025-06-08 17:17:13.621041
286efdc83e4b472492ecd9d528707416,7621aee19cf24e839beb7697bdf2946d,2025-05-19,Talk run determine seat.,-4782.64,Debit,42424.71,,system,2025-06-08 17:17:13.621041,system,2025-06-08 17:17:13.621041
71585374f10c4237a717711ed2ec9711,7621aee19cf24e839beb7697bdf2946d,2025-05-03,Others possible another.,3501.54,Credit,45926.25,,system,2025-06-08 17:17:13.621041,system,2025-06-08 17:17:13.621041
27fb496f3b18434895ceae39ffa8bca3,7621aee19cf24e839beb7697bdf2946d,2025-01-12,Day method pressure century alone.,-607.25,Debit,45319.0,,system,2025-06-08 17:17:13.621041,system,2025-06-08 17:17:13.621041
e5a9ebf3ffb14773a113abd602df715f,7621aee19cf24e839beb7697bdf2946d,2025-03-15,Happen box debate military fight personal clearly.,-1226.27,Debit,44092.73,,system,2025-06-08 17:17:13.621041,system,2025-06-08 17:17:13.621041
f1883e6019084156a592296ceac0e962,7621aee19cf24e839beb7697bdf2946d,2025-01-03,No meeting he break return.,-4159.41,Debit,39933.32,,system,2025-06-08 17:17:13.621041,system,2025-06-08 17:17:13.621041
1655ee173fb24be0a68069ba2be1fb2c,7621aee19cf24e839beb7697bdf2946d,2025-06-08,Man house argue top drop low simple.,1485.22,Credit,41418.54,,system,2025-06-08 17:17:13.621041,system,2025-06-08 17:17:13.621041
bc79b0f6008e40eb9d0aef28cae468e0,7621aee19cf24e839beb7697bdf2946d,2024-12-26,Billion two sign only claim stand president mind.,2590.92,Credit,44009.46,,system,2025-06-08 17:17:13.621041,system,2025-06-08 17:17:13.621041
2daaba6a042441768c35e0980f2fa765,7621aee19cf24e839beb7697bdf2946d,2025-03-06,Study film participant provide like be.,4206.61,Credit,48216.07,,system,2025-06-08 17:17:13.621041,system,2025-06-08 17:17:13.621041
5e519b6252224c8b9c2dbf75a97a88f4,7621aee19cf24e839beb7697bdf2946d,2025-02-03,Scene protect technology country.,-3525.7,Debit,44690.37,,system,2025-06-08 17:17:13.621041,system,2025-06-08 17:17:13.621041
ba5a47d1733a49548d7c944b49cdd755,d519d58f216a4f19b583b8f41b23e6ca,2025-01-25,Its break professional hotel.,-403.34,Debit,49596.66,,system,2025-06-08 17:17:13.621041,system,2025-06-08 17:17:13.621041
f1aac05fb21948ddb590601dcd4ce1c9,d519d58f216a4f19b583b8f41b23e6ca,2025-02-07,Wish mind record every successful some.,-1239.52,Debit,48357.14,,system,2025-06-08 17:17:13.621041,system,2025-06-08 17:17:13.621041
b2c678c1f41948409b038dcf22210827,d519d58f216a4f19b583b8f41b23e6ca,2025-04-14,Free close heavy seat consider want.,-4512.27,Debit,43844.87,,system,2025-06-08 17:17:13.621041,system,2025-06-08 17:17:13.621041
f402a724a8ee4bc68ef907fe108483c7,d519d58f216a4f19b583b8f41b23e6ca,2025-02-22,Student generation loss save idea who.,-1127.09,Debit,42717.78,,system,2025-06-08 17:17:13.621041,system,2025-06-08 17:17:13.621041
7f1223402b964860afa2b2da6644ed0c,d519d58f216a4f19b583b8f41b23e6ca,2025-04-20,Man law buy assume card spring yard there.,-3533.19,Debit,39184.59,,system,2025-06-08 17:17:13.621041,system,2025-06-08 17:17:13.621041
9e54b766835541869ce6bfc455974778,d519d58f216a4f19b583b8f41b23e6ca,2025-04-14,They year travel project allow rule hope.,2473.58,Credit,41658.17,,system,2025-06-08 17:17:13.621041,system,2025-06-08 17:17:13.621041
98d04674d03a4245b65b887b7b91ab03,d519d58f216a4f19b583b8f41b23e6ca,2024-12-16,Spring later heavy international.,-2462.71,Debit,39195.46,,system,2025-06-08 17:17:13.621041,system,2025-06-08 17:17:13.621041
879cd30b2916449b943c3c1068120bec,d519d58f216a4f19b583b8f41b23e6ca,2024-12-30,Act wait modern good south talk nation medical.,-2187.41,Debit,37008.05,,system,2025-06-08 17:17:13.621041,system,2025-06-08 17:17:13.621041
69884e6dacae4bb99ca0f0f2b0819594,d519d58f216a4f19b583b8f41b23e6ca,2025-02-25,Present usually security onto argue account matter.,951.33,Credit,37959.38,,system,2025-06-08 17:17:13.621041,system,2025-06-08 17:17:13.621041
b727937b068946008176959017d72dea,d519d58f216a4f19b583b8f41b23e6ca,2025-01-06,Past camera doctor Mrs whose.,86.7,Credit,38046.08,,system,2025-06-08 17:17:13.621041,system,2025-06-08 17:17:13.621041
cc9c04691a8f46aba19404901499168f,96e8d8782a7943f882ed5fa24a72da2e,2025-04-07,Check guess next similar former of house.,-1224.8,Debit,48775.2,,system,2025-06-08 17:17:13.621041,system,2025-06-08 17:17:13.621041
aee737b04bfa43a281164e63c99ba840,96e8d8782a7943f882ed5fa24a72da2e,2025-01-22,Understand life statement computer hold not win blue.,-2673.71,Debit,46101.49,,system,2025-06-08 17:17:13.621041,system,2025-06-08 17:17:13.621041
973e98597c97401da17225b15bb83370,96e8d8782a7943f882ed5fa24a72da2e,2025-05-01,Oil article this strong.,-4280.61,Debit,41820.88,,system,2025-06-08 17:17:13.621041,system,2025-06-08 17:17:13.621041
436fbb635fff4ebd9d88fd88ef652147,96e8d8782a7943f882ed5fa24a72da2e,2025-03-06,Tell you song simply.,-3038.24,Debit,38782.64,,system,2025-06-08 17:17:13.621041,system,2025-06-08 17:17:13.621041
8866569e3044408e9875908465a7a7fc,96e8d8782a7943f882ed5fa24a72da2e,2025-02-21,Need husband huge drive meet future.,-602.56,Debit,38180.08,,system,2025-06-08 17:17:13.621041,system,2025-06-08 17:17:13.621041
28ded6052e56493b8d876fcbf874af36,96e8d8782a7943f882ed5fa24a72da2e,2025-05-27,Fine visit something answer success.,-4112.23,Debit,34067.85,,system,2025-06-08 17:17:13.621041,system,2025-06-08 17:17:13.621041
253209461f604f1abbce27461db9ef0a,96e8d8782a7943f882ed5fa24a72da2e,2025-04-13,Crime great allow fine rule executive trial.,-515.07,Debit,33552.78,,system,2025-06-08 17:17:13.621041,system,2025-06-08 17:17:13.621041
de0065c0e97443b690340b6a2547e327,96e8d8782a7943f882ed5fa24a72da2e,2025-02-14,He decision goal Democrat minute.,3381.98,Credit,36934.76,,system,2025-06-08 17:17:13.621041,system,2025-06-08 17:17:13.621041
f7afc673ee1d4bff87ac4a7ace369c45,96e8d8782a7943f882ed5fa24a72da2e,2025-03-09,Onto line by attack research trial.,-1985.47,Debit,34949.29,,system,2025-06-08 17:17:13.621041,system,2025-06-08 17:17:13.621041
d68249ef21234f61ad2516384eb5bebf,96e8d8782a7943f882ed5fa24a72da2e,2025-02-19,Cell front good pick baby.,-390.16,Debit,34559.13,,system,2025-06-08 17:17:13.621041,system,2025-06-08 17:17:13.621041
2810a8a1a4b24e3e92f9d4d2abb3a15c,cd029afc492242878605fc064b42a825,2025-02-23,Change development recognize hold.,-3269.41,Debit,46730.59,,system,2025-06-08 17:17:13.621041,system,2025-06-08 17:17:13.621041
e33a3875d2924ba6ab0194e4f13b0ba4,cd029afc492242878605fc064b42a825,2025-03-01,In because piece happy head.,3901.92,Credit,50632.51,,system,2025-06-08 17:17:13.621041,system,2025-06-08 17:17:13.621041
6542ba0076d34649b8154de80402c61f,cd029afc492242878605fc064b42a825,2025-02-28,Together maintain put son building.,-2549.97,Debit,48082.54,,system,2025-06-08 17:17:13.621041,system,2025-06-08 17:17:13.621041
16112ab5a4c14a59a3e01be3037570b7,cd029afc492242878605fc064b42a825,2025-03-20,How phone age often research.,-555.04,Debit,47527.5,,system,2025-06-08 17:17:13.621041,system,2025-06-08 17:17:13.621041
58a0bff91c0643afa1debfa375ef28a7,cd029afc492242878605fc064b42a825,2025-01-29,Keep apply minute question I.,1966.2,Credit,49493.7,,system,2025-06-08 17:17:13.621041,system,2025-06-08 17:17:13.621041
92d70ccae28c44c1a0e81a87c1215a0a,cd029afc492242878605fc064b42a825,2025-01-18,Professional something hundred reflect everyone stuff.,1142.53,Credit,50636.23,,system,2025-06-08 17:17:13.621041,system,2025-06-08 17:17:13.621041
b3f389d48d2341e18105303ebe68c02d,cd029afc492242878605fc064b42a825,2025-01-05,Health fire seek society.,4148.3,Credit,54784.53,,system,2025-06-08 17:17:13.621041,system,2025-06-08 17:17:13.621041
ce55cd2cb84046f5834aa2c095b77ba9,cd029afc492242878605fc064b42a825,2025-02-02,Model rest hit Mrs everyone.,-116.15,Debit,54668.38,,system,2025-06-08 17:17:13.621041,system,2025-06-08 17:17:13.621041
b5d7d662ff054bc7bce53f461c8dbdec,cd029afc492242878605fc064b42a825,2025-02-02,Interesting school system drive believe off can similar.,-2350.34,Debit,52318.04,,system,2025-06-08 17:17:13.621041,system,2025-06-08 17:17:13.621041
fb789e7d7acf4b3fa03564a0af69feb0,cd029afc492242878605fc064b42a825,2025-03-05,Improve force lot by hold.,4661.88,Credit,56979.92,,system,2025-06-08 17:17:13.621041,system,2025-06-08 17:17:13.621041
a25a6ca3f53e4573906825b46387022a,9057c4a71abc47749fa6bf778dc40365,2024-12-15,Start major worry difference indeed Mrs.,1132.76,Credit,51132.76,,system,2025-06-08 17:17:13.621041,system,2025-06-08 17:17:13.621041
f89711cbbd0a467c8cdd09777f20cc5a,9057c4a71abc47749fa6bf778dc40365,2025-04-08,Experience record research success mouth fill.,-2131.46,Debit,49001.3,,system,2025-06-08 17:17:13.621041,system,2025-06-08 17:17:13.621041
a43ee693744b45f28aa97fd0d0527cb9,9057c4a71abc47749fa6bf778dc40365,2025-01-31,Body management check experience house.,4409.49,Credit,53410.79,,system,2025-06-08 17:17:13.621041,system,2025-06-08 17:17:13.621041
99c3e0123c3a4395b48fa05202feeb15,9057c4a71abc47749fa6bf778dc40365,2025-05-04,Together else particular customer reduce.,2128.62,Credit,55539.41,,system,2025-06-08 17:17:13.621041,system,2025-06-08 17:17:13.621041
25cd8d4ce8c547e296982ad5c7436a03,9057c4a71abc47749fa6bf778dc40365,2025-04-21,Third tend put provide eye tonight.,874.33,Credit,56413.74,,system,2025-06-08 17:17:13.621041,system,2025-06-08 17:17:13.621041
dfd8d04ab93f4cad8e3f0b0100616b77,9057c4a71abc47749fa6bf778dc40365,2025-02-11,Various later throw Congress product personal book.,-538.75,Debit,55874.99,,system,2025-06-08 17:17:13.621041,system,2025-06-08 17:17:13.621041
c4bc3f3530ae45f8b9efc0f3b42d4095,9057c4a71abc47749fa6bf778dc40365,2025-06-01,Behavior wind now.,2872.11,Credit,58747.1,,system,2025-06-08 17:17:13.621041,system,2025-06-08 17:17:13.621041
a4b52acf73b84f2da858d0c58b090d6f,9057c4a71abc47749fa6bf778dc40365,2025-04-08,Claim important focus newspaper still quite them imagine.,4623.03,Credit,63370.13,,system,2025-06-08 17:17:13.621041,system,2025-06-08 17:17:13.621041
7553a2fc8def4f4ba166a4589f508d4f,9057c4a71abc47749fa6bf778dc40365,2025-02-09,Old view ball continue.,-238.02,Debit,63132.11,,system,2025-06-08 17:17:13.621041,system,2025-06-08 17:17:13.621041
cdb90f6dfe534edf872262df802dbf66,9057c4a71abc47749fa6bf778dc40365,2025-02-07,Yet near general.,-801.08,Debit,62331.03,,system,2025-06-08 17:17:13.621041,system,2025-06-08 17:17:13.621041
9cb109640cf44396a777b4948aa0454f,f1109ffca0374c63b0e8394a646b1d85,2025-04-02,Forward data good manager even.,-2186.07,Debit,47813.93,,system,2025-06-08 17:17:13.621041,system,2025-06-08 17:17:13.621041
18adb3b7f15a4eeea62fc468507f413d,f1109ffca0374c63b0e8394a646b1d85,2025-06-03,Short line tend dream.,3721.19,Credit,51535.12,,system,2025-06-08 17:17:13.621041,system,2025-06-08 17:17:13.621041
19a350b29cef4ea8a0fb24024047fbb6,f1109ffca0374c63b0e8394a646b1d85,2025-02-06,Travel hotel time learn trial argue protect.,4582.98,Credit,56118.1,,system,2025-06-08 17:17:13.621041,system,2025-06-08 17:17:13.621041
1eb2b078dcbf4cef98757cc8626dbcf0,f1109ffca0374c63b0e8394a646b1d85,2025-03-10,Determine leader town carry lose.,-787.5,Debit,55330.6,,system,2025-06-08 17:17:13.621041,system,2025-06-08 17:17:13.621041
a61fe804831b4aec8b2064db659e0383,f1109ffca0374c63b0e8394a646b1d85,2025-01-07,Make remember try.,-4194.83,Debit,51135.77,,system,2025-06-08 17:17:13.621041,system,2025-06-08 17:17:13.621041
a1cb4b9cdac24441a29749bdd5894911,f1109ffca0374c63b0e8394a646b1d85,2025-04-18,Few from read hair pattern reveal sure necessary.,-548.48,Debit,50587.29,,system,2025-06-08 17:17:13.621041,system,2025-06-08 17:17:13.621041
e7706ca13a064f1d8be0e1fd7cd75112,f1109ffca0374c63b0e8394a646b1d85,2025-05-20,Oil edge sit newspaper scientist determine.,-2019.52,Debit,48567.77,,system,2025-06-08 17:17:13.621041,system,2025-06-08 17:17:13.621041
e00a435e873e40a6934b9f756f46bd3c,f1109ffca0374c63b0e8394a646b1d85,2025-02-08,Form support effect once range offer during.,-1829.1,Debit,46738.67,,system,2025-06-08 17:17:13.621041,system,2025-06-08 17:17:13.621041
11f44fa0927946b9b3b4b78609fe101b,f1109ffca0374c63b0e8394a646b1d85,2024-12-24,Improve whole star size customer most safe.,2665.31,Credit,49403.98,,system,2025-06-08 17:17:13.621041,system,2025-06-08 17:17:13.621041
433da4ee140741849a049560f4c31448,f1109ffca0374c63b0e8394a646b1d85,2025-05-24,Sister truth bill candidate institution happen culture.,2769.56,Credit,52173.54,,system,2025-06-08 17:17:13.621041,system,2025-06-08 17:17:13.621041
729f242604ce4732b981e700a01321fd,1427632cde9c4fb893c2764c0ecc6eb3,2025-05-25,Measure this artist anyone prove bad.,1219.9,Credit,51219.9,,system,2025-06-08 17:17:13.621041,system,2025-06-08 17:17:13.621041
6ed599def75a4fea92c6e4ba59c91da7,1427632cde9c4fb893c2764c0ecc6eb3,2024-12-26,Action bring girl husband either contain value.,2887.66,Credit,54107.56,,system,2025-06-08 17:17:13.621041,system,2025-06-08 17:17:13.621041
09a066b7d3144d96aaf2571cf2f891bf,1427632cde9c4fb893c2764c0ecc6eb3,2025-01-13,Difficult upon evidence suggest work newspaper may floor.,2176.27,Credit,56283.83,,system,2025-06-08 17:17:13.621041,system,2025-06-08 17:17:13.621041
f9fa02e038cd42b48bd15c7b5c381e93,1427632cde9c4fb893c2764c0ecc6eb3,2025-05-31,Song rich skill fish fill positive hit.,3511.06,Credit,59794.89,,system,2025-06-08 17:17:13.621041,system,2025-06-08 17:17:13.621041
88391caab47e497fb5cccf1797fdf76c,1427632cde9c4fb893c2764c0ecc6eb3,2025-03-05,Record deep indicate throw term figure paper.,2963.09,Credit,62757.98,,system,2025-06-08 17:17:13.621041,system,2025-06-08 17:17:13.621041
8dc00b7ebc474d33bfbb628e1f7b329a,1427632cde9c4fb893c2764c0ecc6eb3,2025-01-30,Also because new generation.,-1015.72,Debit,61742.26,,system,2025-06-08 17:17:13.621041,system,2025-06-08 17:17:13.621041
48bcbee1469f49ceb838dc61656153ec,1427632cde9c4fb893c2764c0ecc6eb3,2025-03-26,Various will parent last staff offer draw position.,-3499.85,Debit,58242.41,,system,2025-06-08 17:17:13.621041,system,2025-06-08 17:17:13.621041
6929924b0a4d44948c4168756bc6e365,1427632cde9c4fb893c2764c0ecc6eb3,2025-03-13,Hit provide during month successful that.,2223.51,Credit,60465.92,,system,2025-06-08 17:17:13.621041,system,2025-06-08 17:17:13.621041
c8aae522bf674903800f4da778e89823,1427632cde9c4fb893c2764c0ecc6eb3,2025-03-15,Hotel century drive identify character sport our.,-2558.34,Debit,57907.58,,system,2025-06-08 17:17:13.621041,system,2025-06-08 17:17:13.621041
1d94bb01d51944438bd0a6e2acfdeddc,1427632cde9c4fb893c2764c0ecc6eb3,2025-02-20,Determine line interest subject speak color they may.,1546.94,Credit,59454.52,,system,2025-06-08 17:17:13.621041,system,2025-06-08 17:17:13.621041
49f4f9679ff94f50989676f964a31f93,a6dcd43a897445089ccc74984a015795,2025-03-13,Hand guess focus media nor others system.,-1345.43,Debit,48654.57,,system,2025-06-08 17:17:13.621041,system,2025-06-08 17:17:13.621041
4ee9368355594360aaeb4f3559232009,a6dcd43a897445089ccc74984a015795,2025-04-18,Believe voice including voice him after.,4538.31,Credit,53192.88,,system,2025-06-08 17:17:13.621041,system,2025-06-08 17:17:13.621041
6684245435664bb6bc9cae2d8379665c,a6dcd43a897445089ccc74984a015795,2025-05-06,Nearly serious support represent.,3649.19,Credit,56842.07,,system,2025-06-08 17:17:13.621041,system,2025-06-08 17:17:13.621041
2f415b663e6e43789a7f2dbf88d4b1ac,a6dcd43a897445089ccc74984a015795,2025-02-18,Small weight next return.,4414.87,Credit,61256.94,,system,2025-06-08 17:17:13.621041,system,2025-06-08 17:17:13.621041
a10573fbf1844d6c90b91a4243637ae5,a6dcd43a897445089ccc74984a015795,2024-12-29,Investment can be season money TV.,4838.53,Credit,66095.47,,system,2025-06-08 17:17:13.621041,system,2025-06-08 17:17:13.621041
218743e727494c04ada21b363bb1ea69,a6dcd43a897445089ccc74984a015795,2024-12-19,Throughout knowledge however.,1835.38,Credit,67930.85,,system,2025-06-08 17:17:13.621041,system,2025-06-08 17:17:13.621041
ee1b4fda11634139839fbebefd413b63,a6dcd43a897445089ccc74984a015795,2025-05-30,About this similar front arm.,2626.92,Credit,70557.77,,system,2025-06-08 17:17:13.621041,system,2025-06-08 17:17:13.621041
52bd9b8831ae4ebbbc6bc3f366f3a594,a6dcd43a897445089ccc74984a015795,2025-06-01,Difference finally nor week feel.,-2397.72,Debit,68160.05,,system,2025-06-08 17:17:13.621041,system,2025-06-08 17:17:13.621041
0ce17eb33c0b45958a9f52b1f530af0b,a6dcd43a897445089ccc74984a015795,2025-01-13,Indicate record condition sister list score.,3554.67,Credit,71714.72,,system,2025-06-08 17:17:13.621041,system,2025-06-08 17:17:13.621041
515bb246a23c475685b918f41fc2ed73,a6dcd43a897445089ccc74984a015795,2025-05-22,Religious act newspaper.,2368.63,Credit,74083.35,,system,2025-06-08 17:17:13.621041,system,2025-06-08 17:17:13.621041
5581f5da5bc94865a2e50d7313273e40,9d0676d0a8524322821b8ae950fdcfff,2025-04-07,Population which best enough when back.,-4400.7,Debit,45599.3,,system,2025-06-08 17:17:13.621041,system,2025-06-08 17:17:13.621041
a2c4d4758bc143a08b4b1e0454095f17,9d0676d0a8524322821b8ae950fdcfff,2025-01-10,Which far scene director matter nor take.,3149.33,Credit,48748.63,,system,2025-06-08 17:17:13.621041,system,2025-06-08 17:17:13.621041
b4712c42abb94927874e1ff2b74a4b45,9d0676d0a8524322821b8ae950fdcfff,2024-12-20,Have wide Mrs from social.,4896.0,Credit,53644.63,,system,2025-06-08 17:17:13.621041,system,2025-06-08 17:17:13.621041
1e9def11816140609fbf3727e13ea99f,9d0676d0a8524322821b8ae950fdcfff,2025-02-21,Guy cut reflect.,-1383.27,Debit,52261.36,,system,2025-06-08 17:17:13.621041,system,2025-06-08 17:17:13.621041
eb8eafe5a7d24bf8a7cc4cf794aff38d,9d0676d0a8524322821b8ae950fdcfff,2025-01-06,Mind each plan.,-4222.03,Debit,48039.33,,system,2025-06-08 17:17:13.621041,system,2025-06-08 17:17:13.621041
9ba8a21a69734b99922734c60baa6f22,9d0676d0a8524322821b8ae950fdcfff,2025-01-06,Nation prepare image me they.,1894.35,Credit,49933.68,,system,2025-06-08 17:17:13.621041,system,2025-06-08 17:17:13.621041
ac37c6ec1a134eea867c5c485794843c,9d0676d0a8524322821b8ae950fdcfff,2025-01-08,Issue herself quickly another difference set suffer.,18.64,Credit,49952.32,,system,2025-06-08 17:17:13.621041,system,2025-06-08 17:17:13.621041
507c4fab75b841e7bf05259e6fc1a28c,9d0676d0a8524322821b8ae950fdcfff,2025-03-20,Knowledge old issue yet worry.,2355.98,Credit,52308.3,,system,2025-06-08 17:17:13.621041,system,2025-06-08 17:17:13.621041
423596e362044479b0aed5a239dc117b,9d0676d0a8524322821b8ae950fdcfff,2025-05-17,Light his where show tax sure.,4936.18,Credit,57244.48,,system,2025-06-08 17:17:13.621041,system,2025-06-08 17:17:13.621041
c0db08efed744158ad729dc407e7a2c2,9d0676d0a8524322821b8ae950fdcfff,2024-12-16,Surface low commercial.,476.19,Credit,57720.67,,system,2025-06-08 17:17:13.621041,system,2025-06-08 17:17:13.621041
9c0388b823c04efd914e259fe95aa4bd,a503455089c54ca3b9437aac3d95884b,2025-01-31,Image north same perform.,3867.31,Credit,53867.31,,system,2025-06-08 17:17:13.621041,system,2025-06-08 17:17:13.621041
0e0c818ba28045e4981f9316df3be1cb,a503455089c54ca3b9437aac3d95884b,2025-02-14,Behavior mouth wish office finish protect quality.,-2849.64,Debit,51017.67,,system,2025-06-08 17:17:13.621041,system,2025-06-08 17:17:13.621041
8f4bfcc2083d43b49239b4406511efa9,a503455089c54ca3b9437aac3d95884b,2025-03-30,Throw real majority medical market place.,2875.55,Credit,53893.22,,system,2025-06-08 17:17:13.621041,system,2025-06-08 17:17:13.621041
7d031cf53a8e4bc993b64d277c27f8c2,a503455089c54ca3b9437aac3d95884b,2025-05-20,Once artist care usually amount goal.,-982.07,Debit,52911.15,,system,2025-06-08 17:17:13.621041,system,2025-06-08 17:17:13.621041
3d046fcbe1f746ee9660730538def115,a503455089c54ca3b9437aac3d95884b,2025-03-22,Miss Congress student different best mind.,-1880.41,Debit,51030.74,,system,2025-06-08 17:17:13.621041,system,2025-06-08 17:17:13.621041
d4569107da6f4af59cc9c773dfd82dd1,a503455089c54ca3b9437aac3d95884b,2025-02-20,Free traditional her bad traditional bit movie.,-296.16,Debit,50734.58,,system,2025-06-08 17:17:13.621041,system,2025-06-08 17:17:13.621041
f427a4bb588644599204d56fe29702a0,a503455089c54ca3b9437aac3d95884b,2025-01-29,Policy southern set.,4233.17,Credit,54967.75,,system,2025-06-08 17:17:13.621041,system,2025-06-08 17:17:13.621041
ffd4cd7723d74aaab1a16df8704c14d8,a503455089c54ca3b9437aac3d95884b,2024-12-25,Perhaps thousand century cut herself partner develop notice.,1428.36,Credit,56396.11,,system,2025-06-08 17:17:13.621041,system,2025-06-08 17:17:13.621041
717feb60bfd24875bca96eee1943dd98,a503455089c54ca3b9437aac3d95884b,2025-02-04,Hand stuff bring.,-916.37,Debit,55479.74,,system,2025-06-08 17:17:13.621041,system,2025-06-08 17:17:13.621041
1154af9501e34f7abea958ca1d45e734,a503455089c54ca3b9437aac3d95884b,2025-03-29,Future who near defense serious.,1689.3,Credit,57169.04,,system,2025-06-08 17:17:13.621041,system,2025-06-08 17:17:13.621041
2d5398b6a6704ba98bfa814e055cdd99,fb3efa5ef8f04d5a927fe2318300e11e,2025-01-10,Near decision organization entire lose itself.,2205.47,Credit,52205.47,,system,2025-06-08 17:17:13.621041,system,2025-06-08 17:17:13.621041
21fab1c3c0334a3a998f16c84d99fb59,fb3efa5ef8f04d5a927fe2318300e11e,2024-12-19,Support quite former miss sing.,-883.91,Debit,51321.56,,system,2025-06-08 17:17:13.621041,system,2025-06-08 17:17:13.621041
0e404d89acec40349f07c3d25afd3523,fb3efa5ef8f04d5a927fe2318300e11e,2025-03-02,Board break however heart man.,1508.99,Credit,52830.55,,system,2025-06-08 17:17:13.621041,system,2025-06-08 17:17:13.621041
ecd59373f6c44b3685f020e92a379817,fb3efa5ef8f04d5a927fe2318300e11e,2025-05-02,Front money us be race specific worry real.,475.6,Credit,53306.15,,system,2025-06-08 17:17:13.621041,system,2025-06-08 17:17:13.621041
05c7d319aed44cd49a0684f7ca2d38a6,fb3efa5ef8f04d5a927fe2318300e11e,2025-06-04,Anyone since live impact.,2081.7,Credit,55387.85,,system,2025-06-08 17:17:13.621041,system,2025-06-08 17:17:13.621041
95c88af5d2d04b70b1ed4074892b5797,fb3efa5ef8f04d5a927fe2318300e11e,2025-05-05,Forget into gas Mrs plant rise.,2403.74,Credit,57791.59,,system,2025-06-08 17:17:13.621041,system,2025-06-08 17:17:13.621041
2f27143dbc494b898e1862dcad34264f,fb3efa5ef8f04d5a927fe2318300e11e,2025-03-13,Thus training look address account interview.,-1311.4,Debit,56480.19,,system,2025-06-08 17:17:13.621041,system,2025-06-08 17:17:13.621041
3cf06fa1ff8b4baf90acb3813faa9a80,fb3efa5ef8f04d5a927fe2318300e11e,2025-01-09,Start see article time perform pretty people.,4779.51,Credit,61259.7,,system,2025-06-08 17:17:13.621041,system,2025-06-08 17:17:13.621041
53034876e2fb44de8a270ea15f5aa3f0,fb3efa5ef8f04d5a927fe2318300e11e,2025-01-25,Of successful child bit window see public.,-1250.73,Debit,60008.97,,system,2025-06-08 17:17:13.621041,system,2025-06-08 17:17:13.621041
309ba62537eb48c681c33ea19cb7c22d,fb3efa5ef8f04d5a927fe2318300e11e,2025-05-22,By base avoid nearly according product finally.,1419.04,Credit,61428.01,,system,2025-06-08 17:17:13.621041,system,2025-06-08 17:17:13.621041
7d26bb63b94041c299e44626aef2a612,fa905e7bc56c4f68a3cafd85fb93a16a,2025-04-27,Benefit spring show.,-2237.74,Debit,47762.26,,system,2025-06-08 17:17:13.621041,system,2025-06-08 17:17:13.621041
7ed0ceda84a446d4a78ac5b8cba75b75,fa905e7bc56c4f68a3cafd85fb93a16a,2024-12-13,Surface good early be successful.,2013.84,Credit,49776.1,,system,2025-06-08 17:17:13.621041,system,2025-06-08 17:17:13.621041
4025f4aa3f024b068fb39549a2c3f51b,fa905e7bc56c4f68a3cafd85fb93a16a,2025-04-23,Hear summer employee.,-2684.43,Debit,47091.67,,system,2025-06-08 17:17:13.621041,system,2025-06-08 17:17:13.621041
33c7089c266f4d6a8bbc7f91bcb726b3,fa905e7bc56c4f68a3cafd85fb93a16a,2025-04-22,Over surface five develop land tree.,742.52,Credit,47834.19,,system,2025-06-08 17:17:13.621041,system,2025-06-08 17:17:13.621041
6c36b2ee880d4bf1810f9ad04e6ba64e,fa905e7bc56c4f68a3cafd85fb93a16a,2025-03-27,Identify letter line these test worker event.,-36.2,Debit,47797.99,,system,2025-06-08 17:17:13.621041,system,2025-06-08 17:17:13.621041
65f74fd28d0a40fabc8617592465d1cf,fa905e7bc56c4f68a3cafd85fb93a16a,2025-03-20,Meeting people lawyer.,3553.65,Credit,51351.64,,system,2025-06-08 17:17:13.621041,system,2025-06-08 17:17:13.621041
eb5aa703b63445e5a68d962d2d9ec3b0,fa905e7bc56c4f68a3cafd85fb93a16a,2025-02-05,Commercial personal police stay despite war.,-2217.61,Debit,49134.03,,system,2025-06-08 17:17:13.621041,system,2025-06-08 17:17:13.621041
37864b26afe741dfafd268b0120c416f,fa905e7bc56c4f68a3cafd85fb93a16a,2024-12-31,Yeah company lead police mouth raise decade.,1804.09,Credit,50938.12,,system,2025-06-08 17:17:13.621041,system,2025-06-08 17:17:13.621041
22c3484fbf4e4dc7b0d9a8cc79321979,fa905e7bc56c4f68a3cafd85fb93a16a,2025-04-25,Science million seat mouth water little.,350.3,Credit,51288.42,,system,2025-06-08 17:17:13.621041,system,2025-06-08 17:17:13.621041
7c45f840abdf416fb9b83c53b02572bc,fa905e7bc56c4f68a3cafd85fb93a16a,2025-05-22,Stay but herself present hard.,4146.26,Credit,55434.68,,system,2025-06-08 17:17:13.621041,system,2025-06-08 17:17:13.621041
